媪	媼
缽	鉢
才	纔
吃	喫
痴	癡
唇	脣
囱	囪
葱	蔥
潀	潨
兑	兌
敚	敓
鈎	鉤
枴	柺
媯	嬀
核	覈
户	戶
棱	棱
稜	棱
秘	祕
啓	啓
啟	啓
鋭	銳
叁	叄
濕	溼
涚	涗
税	稅
説	說
台	臺
抬	擡
枱	檯
蜕	蛻
捝	挩
脱	脫
腽	膃
溈	潙
偽	僞
蒍	蔿
為	爲
衞	衛
温	溫
榅	榲
輼	轀
鰛	鰮
揾	搵
卧	臥
敍	敘
敘	敘
煙	菸
踴	踊
悦	悅
閲	閱
蒀	蒕
氲	氳
煴	熅
愠	慍
緼	縕
醖	醞
藴	蘊
灶	竈
皂	皁
針	鍼
只	只
衹	只
眾	衆
妝	妝
粧	妝
棁	梲
粽	糉
糉	糉
糭	糉
