錒	锕
挨	挨
噯	嗳
鎄	锿
捱	挨
皚	皑
騃	𫘤
藹	蔼
靄	霭
愛	爱
閡	阂
嬡	嫒
薆	𫉁
曖	暧
璦	瑷
礙	碍
鑀	𰾭
靉	叆
庵	庵
菴	庵
諳	谙
鵪	鹌
銨	铵
暗	暗
闇	暗
鮟	𩽾
骯	肮
謸	𫍵
鰲	鳌
鷔	𪉑
媼	媪
襖	袄
奧	奥
驁	骜
釟	𫓥
軷	𫐈
颰	𩙥
鈀	钯
垻	坝
罷	罢
鮊	鲌
壩	坝
擺	摆
襬	䙓 摆
敗	败
韛	𫖔
頒	颁
板	板
鈑	钣
闆	板
絆	绊
辦	办
縍	𫄰
幫	帮
綁	绑
謗	谤
鎊	镑
齙	龅
飽	饱
鴇	鸨
寶	宝
報	报
鉋	铇
鮑	鲍
杯	杯
盃	杯
揹	背
鵯	鹎
鉳	锫
貝	贝
背	背
狽	狈
梖	𪱷
珼	𫞥
備	备
輩	辈
鋇	钡
憊	惫
唄	呗
錛	锛
閍	𨸂
綳	绷
繃	绷
鏰	镚
鎞	𫔇
鰏	鲾
筆	笔
畢	毕
閉	闭
詖	诐
賁	贲
嗶	哔
彃	𪪼
蓽	荜
鉍	铋
飶	𫗣
幣	币
熚	𤇹
潷	滗
篳	筚
鮅	𫚑
斃	毙
蹕	跸
韠	𫖒
贔	赑
鷩	𫜁
編	编
獱	㺍
邊	边
鯾	𫚣
鯿	鳊
籩	笾
貶	贬
閞	𫔰
緶	缏
辮	辫
辯	辩
變	变
颮	飑
標	标
颷	𩙪
鏢	镖
飆	飙
飈	飚
驃	骠
鑣	镳
驫	骉
表	表
錶	表
鰾	鳔
鱉	鳖
別	别
癟	瘪
彆	别
賓	宾
儐	傧
濱	滨
檳	槟
璸	瑸
瀕	濒
繽	缤
鑌	镔
擯	摈
殯	殡
臏	膑
髕	髌
鬢	鬓
稟	禀
餅	饼
並	并
併	并
剝	剥
鉢	钵
撥	拨
餑	饽
鮁	鲅
蹳	𫏆
驋	𩧯
鈸	钹
鉑	铂
蔔	卜
駁	驳
襏	袯
鎛	镈
餺	馎
鵓	鹁
卜	卜
鈽	钸
轐	𫐗
補	补
鵏	𬷕
布	布
佈	布
鈈	钚
餔	𫗦
囃	𠱞
才	才
財	财
纔	才
采	采
寀	采
彩	彩
採	采
綵	䌽 彩
參	参
叄	叁
驂	骖
殘	残
慚	惭
蠶	蚕
慘	惨
穇	䅟
篸	𥮾
黲	黪
摻	掺
燦	灿
倉	仓
傖	伧
滄	沧
獊	𪺷
蒼	苍
艙	舱
鶬	鸧
冊	册
側	侧
廁	厕
惻	恻
測	测
萴	荝
筴	䇲
嵾	㟥
層	层
驓	𫘯
鍤	锸
餷	馇
鑔	镲
奼	姹
詫	诧
釵	钗
儕	侪
齜	龇
蠆	虿
覘	觇
鉆	钻
攙	搀
嬋	婵
禪	禅
蟬	蝉
纏	缠
讒	谗
鑱	镵
饞	馋
剗	刬
產	产
剷	铲
嵼	𡶴
滻	浐
嘽	啴
幝	𪩷
蕆	蒇
諂	谄
燀	𬊤
繟	𦈎
譂	𫟠
鏟	铲
闡	阐
囅	冁
懺	忏
顫	颤
倀	伥
錩	锠
閶	阊
鯧	鲳
萇	苌
腸	肠
嘗	尝
償	偿
嚐	尝
鱨	鲿
厂	厂
場	场
廠	厂
鋹	𬬮
悵	怅
瑒	玚
暢	畅
畼	𪽈
鈔	钞
鼂	鼌
麨	𪎊
車	车
俥	伡
唓	𪠳
硨	砗
徹	彻
綝	𬘭
賝	𫎩
縝	缜
陳	陈
蔯	𫈟
塵	尘
諶	谌
鷐	𫜀
磣	碜
齔	龀
儭	𠋆
櫬	榇
襯	衬
讖	谶
湞	浈
稱	称
撐	撑
赬	赪
檉	柽
蟶	蛏
棖	枨
誠	诚
鋮	铖
懲	惩
騁	骋
吃	吃
喫	吃
絺	𫄨
誺	𫍧
鴟	鸱
癡	痴
彲	彨
馳	驰
遲	迟
恥	耻
齒	齿
勑	𠡠
飭	饬
熾	炽
鶒	𫛶
沖	冲
衝	冲
虫	虫
緟	𫟆
蟲	虫
寵	宠
銃	铳
篘	𥬠
仇	仇
紬	䌷
綢	绸
儔	俦
嬦	𫝩
幬	帱
懤	㤽
薵	䓓
疇	畴
籌	筹
躊	踌
讎	仇 雠
丑	丑
醜	丑
出	出
貙	䝙
齣	出
芻	刍
媰	㛀
蒭	𫇴
廚	厨
鋤	锄
雛	雏
櫥	橱
躕	蹰
儲	储
礎	础
齭	𫜭
齼	𬺓
絀	绌
處	处
觸	触
傳	传
釧	钏
摐	𪭢
瘡	疮
牀	床
闖	闯
創	创
愴	怆
錘	锤
鰆	䲠
唇	唇
純	纯
脣	唇
蓴	莼
錞	𬭚
鶉	鹑
賰	䞐
綽	绰
輟	辍
嚽	𪢕
齪	龊
蠀	𧏗
詞	词
餈	糍
鴜	𪉈
辭	辞
鷀	鹚
鮆	𫚖
賜	赐
囪	囱
蓯	苁
蔥	葱
樅	枞
瑽	𪻐
聰	聪
鏦	𫓩
驄	骢 𩨂
從	从
誴	𫟡
叢	丛
湊	凑
輳	辏
縬	𦈚
顣	𫖹
攛	撺
躥	蹿
鑹	镩
欑	𪴙
竄	窜
縗	缞
鹺	鹾
躦	躜
銼	锉
錯	错
噠	哒
鎝	𨱏
達	达
薘	荙
躂	跶
鐽	𫟼
韃	鞑
墶	垯
繨	𫄤
軑	轪
帶	带
紿	绐
貸	贷
靆	叇
單	单
鄲	郸
擔	担
殫	殚
癉	瘅
簞	箪
紞	𬘘
撣	掸
膽	胆
誕	诞
僤	𫢸
彈	弹
憚	惮
贉	𫎫
當	当
噹	当 𪠽
璫	珰
襠	裆
簹	筜
鐺	铛
党	党
擋	挡
黨	党
灙	𣺼
欓	𣗋
讜	谠
碭	砀
蕩	荡
壋	垱
檔	档
璗	𬍡
盪	荡
魛	鱽
島	岛
搗	捣
導	导
隯	陦
嶹	𫝵
擣	𢭏
禱	祷
盜	盗
燾	焘
鍀	锝
燈	灯
鄧	邓
鐙	镫
磾	䃅
鍉	𫔂
滌	涤
頔	𬱖
敵	敌
鏑	镝
糴	籴
覿	觌
抵	抵
牴	抵
詆	诋
遞	递
締	缔
諦	谛
螮	䗖
顛	颠
巔	巅
癲	癫
點	点
淀	淀
電	电
墊	垫
澱	淀
雕	雕
鯛	鲷
鵰	雕 𫛲
弔	吊
吊	吊
釣	钓
蓧	𦰏
銱	铞
調	调
窵	窎
絰	绖
嵽	𫶇
諜	谍
鰈	鲽
疊	叠
釘	钉
頂	顶
訂	订
飣	饤
鋌	铤
錠	锭
丟	丢
銩	铥
冬	冬
東	东
倲	㑈
埬	𪣆
崬	岽
氭	𣱝
蝀	𬟽
鼕	冬
鶇	鸫
凍	冻
動	动
棟	栋
絧	𫄡
腖	胨
駧	𩧲
鈄	钭
斗	斗
鬥	斗
閗	𫔯
餖	饾
竇	窦
闍	阇
獨	独
嬻	𪥿
瀆	渎
櫝	椟
殰	㱩
牘	牍
犢	犊
瓄	𪻨
讀	读
黷	黩
賭	赌
篤	笃
鍍	镀
緞	缎
鍛	锻
斷	断
籪	簖
兌	兑
隊	队
綐	䌼
對	对
濧	㳔
懟	怼
鐓	镦
噸	吨
躉	趸
鈍	钝
頓	顿
燉	炖
敓	敚
奪	夺
凙	𪞝
鮵	𫚛
鐸	铎
綞	缍
嚲	亸
飿	饳
墮	堕
痾	疴
訛	讹
鈋	𨱂
鋨	锇
額	额
鵝	鹅
噁	恶 𫫇
堊	垩
軛	轭
惡	恶
魥	𩽹
餓	饿
諤	谔
閼	阏
鍔	锷
顎	颚
鶚	鹗
齶	腭
鱷	鳄
誒	诶
兒	儿
鮞	鲕
鴯	鸸
爾	尔
餌	饵
邇	迩
貳	贰
鉺	铒
發	发
醱	酦
罰	罚
閥	阀
鍅	钫
琺	珐
髮	发
氾	泛
渢	沨
煩	烦
礬	矾
鐇	𫔍
鷭	𬸪
釩	钒
汎	泛
泛	泛
范	范
販	贩
軬	𫐊
飯	饭
範	范
鈁	钫
魴	鲂
鰟	鳑
仿	仿
紡	纺
訪	访
鶭	𫛯
飛	飞
緋	绯
騑	𬴂
誹	诽
費	费
廢	废
曊	𪰶
櫠	𪲮
鯡	鲱
鐨	镄
紛	纷
訜	𫍛
鈖	𫟴
墳	坟
幩	𪩸
濆	𣸣
魵	𫚍
羵	𫅗
豶	豮
鐼	𫔁
僨	偾
憤	愤
奮	奋
膹	𪱥
糞	粪
鱝	鲼
丰	丰
風	风
峯	峰
偑	㐽
楓	枫
瘋	疯
碸	砜
鋒	锋
豐	丰
灃	沣
麷	𫜑
馮	冯
諷	讽
鳳	凤
縫	缝
賵	赗
鴀	𫛜
夫	夫
伕	夫
鈇	𫓧
膚	肤
麩	麸
麬	𤿲
佛	佛
彿	佛
紱	绂
紼	绋
絥	𫄢
鳧	凫
韍	韨
鴔	𫛡
輻	辐
鮄	𫚒
鵩	𫛳
輔	辅
嘸	呒
撫	抚
頫	𫖯
訃	讣
負	负
婦	妇
復	复
複	复
緮	𫄭
賦	赋
駙	驸
縛	缚
鮒	鲋
賻	赙
覆	复
鰒	鳆
釓	钆
該	该
賅	赅
鈣	钙
隑	𬮿
蓋	盖
杆	杆
尷	尴
桿	杆
稈	秆
趕	赶
鱤	鳡
干	干
紺	绀
幹	干
贑	𫎬
贛	赣
岡	冈
剛	刚
掆	㧏
棡	㭎
綱	纲
鋼	钢
崗	岗
杠	杠
槓	杠
縞	缟
誥	诰
鋯	锆
鴐	𫛤
擱	搁
鴿	鸽
鎶	鿔
閣	阁
閤	合
鮯	𫚗
韚	𫠅
騔	𩨀
嗰	𠮶
個	个
箇	个
鉻	铬
給	给
亘	亘
亙	亘
揯	搄
緪	縆
賡	赓
鶊	鹒
綆	绠
鯁	鲠
宮	宫
碽	䂵
龔	龚
鞏	巩
貢	贡
溝	沟
鉤	钩
緱	缑
韝	鞲 𫖕
夠	够
詬	诟
構	构
覯	觏
購	购
軲	轱
鈲	𨱃
鴣	鸪
鶻	鹘
谷	谷
詁	诂
鈷	钴
穀	谷
縎	𦈔
轂	毂
餶	馉
蠱	蛊
僱	雇
錮	锢
鯝	鲴
顧	顾
刮	刮
煱	㶽
颳	刮
鴰	鸹
騧	䯄
剮	剐
挂	挂
掛	挂
詿	诖
摑	掴
拐	拐
柺	拐
關	关
鰥	鳏
觀	观
輨	𫐑
館	馆
貫	贯
慣	惯
摜	掼
鏆	𨱌
鸛	鹳
輄	𨐈
广	广
廣	广
獷	犷
規	规
閨	闺
嬀	妫
槼	椝
璝	𪻺
鮭	鲑
龜	龟
歸	归
鬹	鬶
軌	轨
匭	匦
詭	诡
柜	柜
貴	贵
匱	匮
劊	刽
劌	刿
槶	椢
檜	桧
瞶	瞆
簂	𫂆
櫃	柜
癐	𤶊
襘	𫋻
鱖	鳜
袞	衮
滾	滚
緄	绲
輥	辊
鯀	鲧
咼	呙
堝	埚
鈛	𫓨
嘓	啯
濄	㳡
鍋	锅
蟈	蝈
國	国
幗	帼
漍	𬇹
膕	腘
槨	椁
錁	锞
餜	馃
過	过
頦	颏
還	还
駭	骇
頇	顸
魽	𫠐
韓	韩
閈	闬
馯	𫘛
漢	汉
頷	颔
駻	𫘣
絎	绗
頏	颃
蚝	蚝
蠔	蚝
號	号
鎬	镐
顥	颢
灝	灏
訶	诃
合	合
紇	纥
核	核
頜	颌
魺	鲄
闔	阖
齕	龁
覈	核
鶡	鹖
鑉	𫠁
賀	贺
鶴	鹤
詪	𬣳
恆	恒
橫	横
鴴	鸻
哄	哄
輷	𫐒
轟	轰
紅	红
紘	纮
葒	荭
閎	闳
綋	𫟄
鉷	𫟹
魟	𫚉
鋐	𬭎
鴻	鸿
黌	黉
嗊	唝
訌	讧
鬨	哄
鍭	𬭤
餱	糇 𫗯
后	后
後	后
鮜	鲘
鱟	鲎
軤	轷
胡	胡
壺	壶
衚	胡
餬	𫗫
鵠	鹄
鬍	胡
鶘	鹕
鶦	𫛷
滸	浒
鯱	𩾇
戶	户
滬	沪
嚛	𪠸
護	护
鱯	鳠
鸌	鹱
嘩	哗
華	华
譁	哗
鏵	铧
驊	骅
鷨	𪉊
划	划
畫	画
話	话
劃	㓰 划
樺	桦
嫿	婳
澅	𣶩
諣	𫍩
懷	怀
壞	坏
鴅	𫛝
歡	欢
絙	𫄠
綄	𬘫
鉮	𬬹
環	环
鍰	锾
繯	缳
鐶	镮
闤	阛
瓛	𤩽
緩	缓
奐	奂
喚	唤
換	换
渙	涣
煥	焕
瘓	痪
鯇	鲩
鯶	𩽼
黃	黄
鍠	锽
餭	𫗮
鐄	𨱑
騜	𫘩
鰉	鳇
謊	谎
媈	𫝨
揮	挥
暉	晖
煇	𪸩
詼	诙
褘	袆
噅	𠯠
撝	㧑
翬	翚
輝	辉
回	回
迴	回
鮰	𫚔
毀	毁
燬	毁
譭	毁
匯	汇
彙	汇
會	会
賄	贿
誨	诲
噦	哕
殨	㱮
澮	浍
獩	𤞃
薈	荟
諱	讳
頮	颒
燴	烩
璯	㻅
穢	秽
繢	缋
繪	绘
翽	翙
譓	𬤝
闠	阓
靧	𫖃
葷	荤
閽	阍
堚	𪣒
渾	浑
琿	珲
餛	馄
諢	诨
鍃	锪
騞	𬴃
伙	伙
鈥	钬
夥	伙
貨	货
楇	𣒌
禍	祸
獲	获
穫	获
鑊	镬
飢	饥
勣	𪟝
跡	迹
銈	𫓯
嘰	叽
緝	缉
機	机
璣	玑
積	积
襀	𫌀
錤	𫓹
隮	𬯀
擊	击
磯	矶
績	绩
櫅	𪲎
蹟	迹
雞	鸡
譏	讥
饑	饥
躋	跻
齎	赍
齏	齑
羈	羁
极	极
級	级
極	极
輯	辑
藉	借
鶺	鹡
几	几
幾	几
魢	鱾
擠	挤
蟣	虮
紀	纪
計	计
記	记
際	际
誋	𫍪
劑	剂
薊	蓟
嚌	哜
濟	济
薺	荠
覬	觊
檵	𪲛
繼	继
鱀	𬶨
霽	霁
鰶	𬶭
鱭	鲚
驥	骥
夾	夹
家	家
浹	浃
梜	𬂩
傢	家
鉿	铪
鎵	镓
郟	郏
莢	荚
蛺	蛱
餄	饸
鋏	铗
頰	颊
鵊	𫛥
賈	贾
鉀	钾
檟	槚
价	价
價	价
駕	驾
奸	奸
戔	戋
姦	奸
堅	坚
間	间
監	监
箋	笺
樫	㭴
緘	缄
蕳	𫈉
鳽	𫛚
縑	缣
艱	艰
鐧	锏
殲	歼
鶼	鹣
鰹	鲣
韉	鞯
梘	枧
揀	拣
減	减
筧	笕
戩	戬
儉	俭
撿	捡
檢	检
襇	裥
襉	裥
瞼	睑
礆	硷
簡	简
繭	茧
籛	篯
譾	谫 𫍿
鹼	碱
見	见
荐	荐
漸	渐
劍	剑
澗	涧
諓	𬣡
賤	贱
踐	践
薦	荐
諫	谏 𫍝
鍵	键
餞	饯
濺	溅
艦	舰
鑑	鉴
鑒	鉴
姜	姜
將	将
僵	僵
漿	浆
薑	姜
殭	僵
螿	螀
繮	缰
鱂	鳉
蔣	蒋
槳	桨
獎	奖
講	讲
絳	绛
醬	酱
嬌	娇
澆	浇
膠	胶
鮫	鲛
鵁	䴔
轇	𫐖
鐎	𨱓
驕	骄
鷦	鹪
絞	绞
腳	脚
僥	侥
鉸	铰
餃	饺
撟	挢
矯	矫
蟜	𫊸
繳	缴
譑	𫍤
攪	搅
較	较
嶠	峤
轎	轿
階	阶
癤	疖
謯	𫍹
杰	杰
訐	讦
傑	杰
結	结
節	节
詰	诘
潔	洁
鮚	鲒
屆	届
借	借
誡	诫
釒	钅
紟	𫄛
釿	𬬱
巹	卺
僅	仅
盡	尽
緊	紧
儘	侭 尽
錦	锦
謹	谨
饉	馑
勁	劲
晉	晋
進	进
璡	琎
縉	缙
壗	𡋤
濜	浕
藎	荩
燼	烬
覲	觐
贐	赆
荊	荆
涇	泾
莖	茎
經	经
鯨	鲸
鶄	䴖
驚	惊
剄	刭
頸	颈
俓	𠇹
弳	弪
徑	径
逕	迳
桱	𣐕
淨	净
脛	胫
痙	痉
靚	靓
靜	静
鏡	镜
競	竞
絅	䌹
駉	𬳶
駫	𫘡
熲	颎
糺	𫄙
糾	纠
鳩	鸠
鬮	阄
廄	厩
舊	旧
欍	𣐤
鷲	鹫
鋦	锔
駒	驹
鮈	𬶋
局	局
侷	局
駶	𩧺
鶪	䴗
矩	矩
榘	矩
舉	举
櫸	榉
齟	龃
巨	巨
据	据
詎	讵
鉅	巨 钜
寠	𪧘
劇	剧
據	据
窶	窭
鋸	锯
屨	屦
颶	飓
貗	𫎌
懼	惧
鵑	鹃
鐫	镌
卷	卷
捲	卷
錈	锩
雋	隽
絹	绢
縳	䌸
撧	𪮖
屩	𪨗
蹻	𫏋
決	决
訣	诀
絕	绝
駃	𫘝
蕝	𫈵
鴃	𫛞
譎	谲
鶌	𫛵
覺	觉
鐍	𫔎
鐝	镢
灍	𫞝
钁	䦆 镢
軍	军
鈞	钧
皸	皲
銁	𫓲
鮶	鲪
俊	俊
儁	俊
餕	馂
駿	骏
開	开 𫔭
鐦	锎
凱	凯
剴	剀
塏	垲
愷	恺
鍇	锴
鎧	铠
闓	闿
愾	忾
龕	龛
檻	槛
轗	𫐘
闞	阚
鱇	𩾌
鈧	钪
閌	闶
銬	铐
鮳	鲓
軻	轲
鈳	钶
顆	颗
殼	壳
克	克
緙	缂
課	课
騍	骒
剋	克
墾	垦
懇	恳
齦	龈
硜	硁
鏗	铿
剾	𠛅
彄	𫸩
摳	抠
瞘	眍
扣	扣
釦	扣
庫	库
絝	绔
褲	裤
嚳	喾
夸	夸
誇	夸
擓	㧟
塊	块
儈	侩
鄶	郐
噲	哙
獪	狯
膾	脍
鱠	鲙
寬	宽
臗	𣎑
髖	髋
誆	诓
誑	诳
鵟	𫛭
儣	𠆲
況	况
貺	贶
鄺	邝
壙	圹
曠	旷
礦	矿
纊	纩
窺	窥
虧	亏
巋	岿
騤	骙
頍	𫠆
嘳	𪡞
嬇	𫝬
憒	愦
潰	溃
蕢	蒉
謉	𫍷
簣	篑
聵	聩
饋	馈
昆	昆
崑	昆
褌	裈
瑻	𪻲
錕	锟
騉	𫘥
鯤	鲲
鵾	鹍
壼	壸
閫	阃
困	困
睏	困
擴	扩
闊	阔
鬠	𫘽
腊	腊
蜡	蜡
攋	𪮶
臘	腊
鯻	𬶟
蠟	蜡
鑞	镴
來	来
倈	俫
婡	𫝫
崍	崃
徠	徕
淶	涞
萊	莱
棶	梾
錸	铼
麳	𪎌
睞	睐
賚	赉
賴	赖
顂	𩓋
瀨	濑
癩	癞
襰	𧝝
籟	籁
嵐	岚
藍	蓝
闌	阑
璼	𫞨
襤	褴
攔	拦
瀾	澜
籃	篮
繿	䍀
蘭	兰
斕	斓
欄	栏
襴	襕
囒	𪢠
灡	㳕
讕	谰
躝	𨅬
壈	𡒄
懶	懒
孄	𫝮
覽	览
攬	揽
欖	榄
纜	缆
濫	滥
爛	烂
鑭	镧
鋃	锒
鎯	𨱍
閬	阆
撈	捞
勞	劳
嘮	唠
嶗	崂
朥	𦛨
癆	痨
鐒	铹
銠	铑
澇	涝
橯	𣓿
耮	耢
樂	乐
鰳	鳓
了	了
餎	饹
縲	缧
鐳	镭
轠	𫐙
虆	蔂
誄	诔
壘	垒
淚	泪
類	类
纇	颣
厘	厘
漓	漓
縭	缡
離	离
鯬	𫚞
灕	漓
蘺	蓠
孋	㛤
籬	篱
纚	𫄥
驪	骊
鱺	鲡
鸝	鹂
里	里
裏	里
鋰	锂
禮	礼
鯉	鲤
邐	逦
鱧	鳢
栗	栗
慄	栗
蒞	莅
鉝	𫟷
厲	厉
綟	𫄫
勵	励
曆	历
歷	历
鴗	𫁡
濿	𪵱
癘	疠
隸	隶
爄	𤇃
鎘	镉
嚦	呖
壢	坜
櫟	栎
瀝	沥
瓅	𬍛
礪	砺
藶	苈
麗	丽
櫪	枥
礫	砾
糲	粝
蠣	蛎
儷	俪
癧	疬
酈	郦
鷅	𫛽
躒	跞
轢	轹
欐	𪲔
轣	𫐆
靂	雳
倆	俩
帘	帘
連	连
嗹	𪡏
漣	涟
蓮	莲
奩	奁
槤	梿
憐	怜
褳	裢
縺	𦈐
聯	联
鎌	镰
簾	帘
鐮	镰
鰱	鲢
璉	琏
斂	敛
臉	脸
襝	裣
蘞	蔹
煉	炼
練	练
殮	殓
鍊	炼 链 𫔀
鏈	链
瀲	潋
鰊	𬶠
戀	恋
梁	梁
涼	凉
綡	𫟅
樑	梁
輬	辌
糧	粮
兩	两
啢	唡
掚	𪭵
魎	魉
諒	谅
輛	辆
鍄	𨱉
遼	辽
療	疗
繚	缭
鐐	镣
鷯	鹩
釕	钌
瞭	了
鮤	𫚓
鴷	䴕
獵	猎
鱲	𫚭
鄰	邻
臨	临
轔	辚
壣	𪤚
鏻	𬭸
驎	𬴊
鱗	鳞
凜	凛
廩	廪
懍	懔
檁	檩
賃	赁
閵	𫔴
藺	蔺
躪	躏
凌	凌
淩	凌
軨	𫐉
鈴	铃
閝	𫠂
綾	绫
錂	𨱋
鴒	鸰
鯪	鲮
齡	龄
靈	灵
欞	棂
爧	𫞠
領	领
嶺	岭
劉	刘
瀏	浏
鎦	镏
鏐	镠
飀	飗
騮	骝
鶹	鹠
綹	绺
鋶	锍
餾	馏
鷚	鹨
龍	龙
嚨	咙
瀧	泷
蘢	茏
曨	昽
朧	胧
櫳	栊
爖	𤇭
瓏	珑
矓	眬
礱	砻
籠	笼
聾	聋
躘	𨀁
鸗	𫛟
篢	𬕂
隴	陇
壟	垄
壠	垅
攏	拢
龓	𫜲
徿	𪫌
贚	𫎦
瞜	䁖
婁	娄
僂	偻
嘍	喽
慺	㥪
漊	溇
蔞	蒌
遱	𫐷
樓	楼
熡	𤋏
耬	耧
螻	蝼
謱	𫍴
髏	髅
塿	𪣻
嶁	嵝
摟	搂
簍	篓
瘻	瘘
鏤	镂
盧	卢
嚧	𠰷
壚	垆
廬	庐 𪪏
瀘	泸
蘆	芦
曥	𣆐
櫨	栌
爐	炉
臚	胪
矑	𪾦
艫	舻
蠦	𫊮
轤	轳
鑪	𬬻
顱	颅
鱸	鲈
鸕	鸬
鹵	卤
虜	虏
滷	卤
魯	鲁
擄	掳
磠	硵
嚕	噜
擼	撸
瀂	澛
櫓	橹
氌	氇
艣	𫇛
鐪	𫓺
鑥	镥
彔	录
陸	陆
淥	渌
祿	禄
賂	赂
輅	辂
錄	录
轆	辘
騄	𫘧
騼	𫠋
籙	箓
鷺	鹭
閭	闾
膢	𦝼
櫚	榈
驢	驴
呂	吕
侶	侣
屢	屡
鋁	铝
褸	褛
縷	缕
穭	稆 穞
綠	绿
慮	虑
繂	𫄴
濾	滤
孌	娈
孿	孪
巒	峦
攣	挛
欒	栾
臠	脔
圞	𪢮
灤	滦
鑾	銮
鸞	鸾
亂	乱
鋝	锊
擽	㧰
掄	抡
侖	仑
倫	伦
圇	囵
崙	仑 𪨧
淪	沦
菕	𰰨
綸	纶
輪	轮
錀	𬬭
埨	𫭢
論	论
囉	啰
腡	脶
羅	罗
鏍	镙
儸	㑩
覼	𫌨
騾	骡
玀	猡
蘿	萝
邏	逻
欏	椤
籮	箩
鑼	锣
饠	𫗩
絡	络
犖	荦
駱	骆
濼	泺
媽	妈
嬤	嬷
馬	马
瑪	玛
碼	码
螞	蚂
鎷	𨰾
傌	㐷
獁	犸
嘜	唛
榪	杩
禡	祃
罵	骂
嗎	吗
買	买 𧹒
嘪	𪡃
蕒	荬
脈	脉
麥	麦
勱	劢
賣	卖
邁	迈
霢	霡
樠	𣗊
瞞	瞒
謾	谩
饅	馒
顢	颟
鰻	鳗
蠻	蛮
滿	满
蟎	螨
蔄	𬜬
縵	缦
鏝	镘
鋩	铓
貓	猫
犛	牦
錨	锚
鉚	铆
貿	贸
麼	么 麽
沒	没
鋂	𰾄
鎇	镅
鶥	鹛
黴	霉
鎂	镁
門	门
捫	扪
璊	𫞩
鍆	钔
悶	闷
燜	焖
懣	懑
們	们
蒙	蒙
鄳	𫑡
懞	蒙
濛	蒙
矇	蒙
鸏	鹲
錳	锰
夢	梦
謎	谜
彌	弥
擟	𪭧
禰	祢
瀰	㳽 弥
獼	猕
瓕	𤦀
羋	芈
祕	秘
覓	觅
覛	𫌪
冪	幂
謐	谧
綿	绵
黽	黾
緬	缅
澠	渑
鮸	𩾃
面	面
麪	面 麺
鶓	鹋
緲	缈
廟	庙
滅	灭
蔑	蔑
衊	蔑
緍	𦈏
緡	缗
閔	闵
閩	闽
憫	悯
潣	𫞗
簢	𫂃
鰵	鳘
銘	铭
鳴	鸣
謬	谬
謨	谟
饃	馍
歿	殁
鏌	镆
驀	蓦
纆	𬙊
鉾	𫓴
謀	谋
繆	缪
墲	𪢸
畝	亩
鉧	𬭁
鉬	钼
縸	𫄲
鎿	镎
吶	呐
納	纳
軜	𫐇
鈉	钠
孻	𡥧
錼	镎
難	难
譨	𫍦
饢	馕
碙	𥐻
撓	挠
憹	𢙐
蟯	蛲
譊	𫍢
鐃	铙
堖	垴
惱	恼
腦	脑
鬧	闹
訥	讷
餒	馁
內	内
輗	𫐐
鯢	鲵
齯	𫠜
鈮	铌
擬	拟
聻	𫆏
暱	昵
膩	腻
鮎	鲇
鯰	鲶
輦	辇
攆	撵
躎	䟢
念	念
唸	念
娘	娘
孃	娘
釀	酿
鳥	鸟
嫋	袅
裊	袅
蔦	茑
樢	㭤
隉	陧
錜	𫓻
嚙	啮
聶	聂
鎳	镍
闑	𫔶
櫱	蘖
籋	𥬞
囁	嗫
齧	啮 𫜩
躡	蹑
鑷	镊
顳	颞
苧	苎
甯	宁
寧	宁
嚀	咛
嬣	𪥰
擰	拧
獰	狞
薴	苧
檸	柠
聹	聍
鸋	𫛢
濘	泞
紐	纽
鈕	钮
農	农
儂	侬
噥	哝
濃	浓
蕽	𫇽
燶	㶶
膿	脓
穠	秾
醲	𬪩
繷	𫄣
駑	驽
釹	钕
餪	𫗬
瘧	疟
儺	傩
諾	诺
塸	𫭟
漚	沤
歐	欧
毆	殴
熰	𬉼
甌	瓯
謳	讴
鷗	鸥
嘔	呕
慪	怄
盤	盘
蹣	蹒
詊	𫟟
彷	仿
龎	厐
龐	庞
拋	抛
皰	疱
礮	𪿫
賠	赔
浿	𬇙
轡	辔
噴	喷
鵬	鹏
紕	纰
鈹	铍
駓	𬳵
鮍	鲏
鵧	𫛨
羆	罴
辟	辟
闢	辟
鷿	𬸯
鸊	䴙
駢	骈
諞	谝
騙	骗
飄	飘
縹	缥
貧	贫
頻	频
嬪	嫔
矉	𪾸
蠙	𧏖
顰	颦
苹	苹
評	评
軿	𫐌
憑	凭
鮃	鲆
蘋	苹 𬞟
鉕	钷
頗	颇
潑	泼
鏺	䥽
駊	𫘟
釙	钋
錇	锫
仆	仆
撲	扑
鯆	𫚙
僕	仆
鏷	镤
朴	朴
樸	朴
譜	谱
鐠	镨
鋪	铺
悽	凄
戚	戚
淒	凄
棲	栖
榿	桤
慼	戚
鏚	𬭭
祇	只
軝	𬨂
頎	颀
齊	齐
錡	锜
臍	脐
騎	骑
騏	骐
蘄	蕲
鯕	鲯
蠐	蛴
鰭	鳍
豈	岂
啓	启
綺	绮
氣	气
訖	讫
棄	弃
磧	碛
千	千
牽	牵
釺	钎
鈆	𫓪
僉	佥
鉛	铅
慳	悭
遷	迁
謙	谦
顅	𫖶
簽	签
鵮	鹐
騫	骞
籤	签
韆	千
乾	干
鈐	钤
鉗	钳
潛	潜
蕁	荨
錢	钱
騝	𩨃
騚	𩨊
淺	浅
脥	𣍰
繾	缱
譴	谴
俔	伣
塹	堑
綪	𬘬
槧	椠
縴	纤
鰜	鳒
嗆	呛
嶈	𡺃
戧	戗
槍	枪
瑲	玱
錆	锖
蹌	跄
鏘	锵
強	强
嬙	嫱
廧	𪪞
薔	蔷
檣	樯
牆	墙
搶	抢
羥	羟
繈	𫄶
鏹	镪
熗	炝
磽	硗
鍬	锹
蹺	跷
喬	乔
僑	侨
嘺	𪡀
蕎	荞
橋	桥
犞	𪺭
礄	硚
鐈	𫓱
鞽	鞒
誚	诮
竅	窍
翹	翘
譙	谯
愜	惬
篋	箧
鍥	锲
竊	窃
欽	钦
嶔	嵚
親	亲
駸	骎
寢	寝
鋟	锓
撳	揿
氫	氢
傾	倾
輕	轻
葝	𫈎
頃	顷
廎	庼
請	请
慶	庆
煢	茕
窮	穷
瓊	琼
藭	䓖
秋	秋
鞦	秋
鰌	䲡
鰍	鳅
鶖	鹙
虯	虬
釚	𫟲
巰	巯
賕	赇
銶	𨱇
鯄	𩾁
鰽	𫚧
曲	曲
區	区
詘	诎
嶇	岖
誳	𫍮
趨	趋
軀	躯
麴	曲 麹
驅	驱
鴝	鸲
詓	𫍜
齲	龋
闃	阒
覷	觑
駩	𩧴
詮	诠
輇	辁
銓	铨
鰁	鳈
權	权
顴	颧
綣	绻
勸	劝
卻	却
确	确
愨	悫
確	确
闋	阕
礐	𬒈
闕	阙
鵲	鹊
羣	群
纕	𬙋
讓	让
嬈	娆
蕘	荛
橈	桡
襓	𫋹
饒	饶
擾	扰
繞	绕
熱	热
紉	纫
紝	纴
訒	讱
軔	轫
絍	𫟃
韌	韧
飪	饪
認	认
馹	驲
絨	绒
榮	荣
嶸	嵘
爃	𫞡
鎔	镕
蠑	蝾
輮	𫐓
鍒	𫔄
銣	铷
鴽	𫛪
顬	颥
縟	缛
軟	软
銳	锐
瞤	𥆧
閏	闰
潤	润
爇	𦶟
灑	洒
鈒	钑
摋	𢫬
颯	飒
薩	萨
鰓	鳃
賽	赛
毿	毵
鬖	𩭹
傘	伞
糝	糁
鏾	𫔌
饊	馓
閐	𨸃
顙	颡
喪	丧
繅	缫
騷	骚
鰠	鳋
鱢	𫚫
掃	扫
嗇	啬
銫	铯
懎	𢠁
澀	涩
穡	穑
繬	𫄱
譅	𰶎
飋	𫗋
槮	椮
剎	刹
殺	杀
紗	纱
樧	榝
魦	𫚌
鎩	铩
鯊	鲨
廈	厦
篩	筛
釃	酾
曬	晒
刪	删
姍	姗
柵	栅
軕	𫐅
幓	㡎
膻	膻
羶	膻
陝	陕
閃	闪
熌	𤇄
訕	讪
釤	钐
銏	𫟶
墠	𫮃
樿	椫
謆	𫍸
繕	缮
贍	赡
鐥	䦅
騸	骟
鱔	鳝
傷	伤
殤	殇
觴	觞
賞	赏
緔	绱
鞝	绱
燒	烧
紹	绍
輋	𪨶
賒	赊
舍	舍
捨	舍
厙	厍
設	设
懾	慑
攝	摄
灄	滠
欇	𪳍
紳	绅
詵	诜
蔘	参
駪	𬳽
鰺	鲹
沈	沈
審	审
諗	谂
嬸	婶
瀋	沈 渖
讅	谉
腎	肾
滲	渗
鋠	𫓵
瘮	瘆
升	升
昇	升
聲	声
繩	绳
胜	胜
勝	胜
聖	圣
尸	尸
屍	尸
師	师
絁	𫄟
溮	浉
溼	湿
獅	狮
詩	诗
鉈	铊
鳲	鸤
蝨	虱
鳾	䴓
鯴	鲺
鰤	𫚕
飠	饣
時	时
塒	埘
溡	𪶄
蒔	莳
實	实
蝕	蚀
識	识
鰣	鲥
駛	驶
适	适
視	视
貰	贳
勢	势
弒	弑
試	试
軾	轼
鈰	铈
飾	饰
適	适
鉽	𫟸
諟	𬤊
諡	谥
謚	谥
釋	释
壽	寿
綬	绶
獸	兽
鏉	𨱒
書	书
紓	纾
軗	𨐅
綀	𦈌
樞	枢
輸	输
攄	摅
贖	赎
藷	𫉄
屬	属
朮	术
術	术
鉥	𬬸
數	数
豎	竖
樹	树
帥	帅
閂	闩
雙	双
孇	𪥫
騻	𫘭
驦	骦
鸘	鹴
誰	谁
涗	涚
稅	税
順	顺
說	说
碩	硕
鎙	𫔈
爍	烁
鑠	铄
糹	纟
私	私
俬	私
絲	丝
噝	咝
廝	厮
緦	缌
螄	蛳
颸	飔
鷥	鸶
釲	𫟳
飼	饲
駟	驷
瀃	𣽷
松	松
鍶	锶
鬆	松
慫	怂
聳	耸
訟	讼
頌	颂
誦	诵
餸	𩠌
搜	搜
蒐	搜
鎪	锼
餿	馊
颼	飕
颾	𩙫
騪	𩨄
擻	擞
藪	薮
籔	䉤
甦	苏
穌	稣
蘇	苏
囌	苏
訴	诉
肅	肃
鋉	𨱈
餗	𫗧
潚	㴋
謖	谡
驌	骕
鷫	鹔
痠	酸
酸	酸
綏	绥
雖	虽
隨	随
歲	岁
誶	谇
繐	𰬸
繸	䍁
鐩	𬭼
孫	孙
猻	狲
蓀	荪
筍	笋
損	损
縮	缩
嗩	唢
瑣	琐
鎈	𫟿
鎍	𫔅
鎖	锁
它	它
牠	它
獺	獭
鰨	鳎
撻	挞
澾	㳠
闒	阘
闥	闼
台	台
苔	苔
臺	台
颱	台
駘	骀
鮐	鲐
薹	苔
檯	台
鈦	钛
態	态
貪	贪
攤	摊
灘	滩
癱	瘫
談	谈
壇	坛
曇	昙
錟	锬
顃	𩖖
罈	坛
譚	谭
鉭	钽
嘆	叹
歎	叹
賧	赕
湯	汤
劏	㓥
鏜	镗
鐋	铴
餳	饧
鎲	镋
儻	傥
钂	镋
燙	烫
絛	绦
濤	涛
韜	韬
綯	绹
檮	梼
騊	𫘦
討	讨
鋱	铽
蟘	𫋌
謄	誊
騰	腾
鰧	䲢
鷉	䴘
綈	绨
緹	缇
銻	锑
題	题
鵜	鹈
騠	𫘨
鯷	鳀
鶗	𫛸
鷤	𫛴
體	体
屜	屉
殢	𣨼
靝	靔
鈿	钿
闐	阗
覥	觍
賟	𧹖
鍩	锘
靦	䩄 腼
條	条
樤	𣔌
齠	龆
鰷	鲦
誂	𫍥
糶	粜
貼	贴
鐵	铁
烴	烃
綎	𬘩
聽	听
廳	厅
頲	颋
同	同
詷	𫍣
銅	铜
鮦	鲖
統	统
衕	同
慟	恸
鍮	𨱎
緰	𦈕
頭	头
禿	秃
鵚	𪉍
涂	涂
塗	涂
鈯	𨱄
圖	图
駼	𬳿
釷	钍
團	团
摶	抟
槫	𣏢
糰	团
隤	𬯎
頹	颓
蛻	蜕
飩	饨
魨	鲀
托	托
挩	捝
託	托 讬
脫	脱
飥	饦
馱	驮
駝	驼
駞	𫘞
鮀	𬶍
鴕	鸵
鼉	鼍
橢	椭
蘀	萚
籜	箨
媧	娲
窪	洼
膃	腽
襪	袜
喎	㖞
彎	弯
壪	塆
灣	湾
玩	玩
紈	纨
頑	顽
翫	玩
挽	挽
綰	绾
輓	挽
万	万
萬	万
澫	𬇕
錽	𫓸
贃	𧹗
網	网
誷	𫍬
輞	辋
瀇	㲿
鰃	鳂
韋	韦
圍	围
幃	帏
湋	𣲗
違	违
維	维
潙	沩
潿	涠
磑	硙
濰	潍
闈	闱
鮠	𬶏
覹	𫌭
偉	伟
葦	苇
暐	𬀩
椲	㭏
煒	炜
瑋	玮
僞	伪
緯	纬
蔿	𫇭
諉	诿
頠	𬱟
薳	䓕
鮪	鲔
韙	韪
喂	喂
爲	为
蝟	猬
衛	卫
懀	𢙓
謂	谓
餧	𫗪
餵	喂 𫗭
轊	𫐕
鏏	𬭬
溫	温
榲	榅
轀	輼 辒
鰮	鳁
紋	纹
聞	闻
馼	𫘜
鳼	𪉃
閿	阌
穩	稳
問	问
搵	揾
鎓	𬭩
鶲	鹟
甕	瓮
渦	涡
萵	莴
窩	窝
撾	挝
蝸	蜗
臥	卧
齷	龌
烏	乌
鄔	邬
嗚	呜
誣	诬
鴮	𫛦
鎢	钨
吳	吴
無	无
蕪	芜
鵐	鹀
熓	𤆡
嫵	妩
廡	庑
憮	怃
潕	𣲘
鵡	鹉
務	务
悞	悮
塢	坞
誤	误
霧	雾
騖	骛
鶩	鹜
餏	饻
錫	锡
釐	厘
譆	𫍻
犧	牺
鸂	㶉
鑴	𫔔
席	席
習	习
蓆	席
覡	觋
騱	𫘬
襲	袭
鰼	鳛
驨	𫘱
諰	𫍰
縰	𫄳
璽	玺
鱚	𬶮
系	系
係	系
細	细
釳	𨰿
綌	绤
熂	𪸕
戱	戯
戲	戏
餼	饩
鬩	阋
繫	系
霼	𪵣
蝦	虾
鰕	𫚥
俠	侠
峽	峡
狹	狭
硤	硖
轄	辖
嚇	吓
秈	籼
銛	铦
憸	𪫺
薟	莶
鍁	锨
鮮	鲜
鶱	𬸣
躚	跹
纖	纤
弦	弦
咸	咸
絃	弦
閑	闲
閒	闲 𫔮
銜	衔
嫺	娴
嫻	娴
撏	挦
賢	贤
諴	𫍯
癇	痫
鹹	咸
鷳	鹇
鷴	鹇
銑	铣
險	险
嶮	崄
獫	猃
獮	狝
蘚	藓
玁	𤞤
顯	显
哯	𠯟
峴	岘
莧	苋
晛	𬀪
現	现
睍	𪾢
羨	羡
蜆	蚬
撊	𪭾
線	线 缐
憲	宪
縣	县
餡	馅
麲	𪎉
獻	献
鄉	乡
廂	厢
薌	芗
緗	缃
鑲	镶
驤	骧
詳	详
餉	饷
曏	向
蠁	蚃
鯗	鲞
響	响
饗	飨
饟	𫗵
向	向
項	项
嚮	向
梟	枭
綃	绡
嘵	哓
憢	𢙒
銷	销
蕭	萧
鴞	鸮
蟂	𫋇
瀟	潇
簫	箫
囂	嚣
蠨	蟏
驍	骁
毊	𪵑
曉	晓
篠	筿
謏	𫍲
嘯	啸
斅	𢽾
斆	敩
蝎	蝎
蠍	蝎
協	协
挾	挟
脅	胁
頡	颉
諧	谐
擷	撷
攜	携
纈	缬
寫	写
屓	屃
紲	绁
緤	𫄬
褻	亵
謝	谢
瀉	泻
齘	𬹼
訢	䜣
廞	𫷷
鋅	锌
鐔	镡
釁	衅
騂	骍
陘	陉
娙	𫰛
鈃	钘
滎	荥
鉶	铏
幸	幸
倖	幸
興	兴
凶	凶
兇	凶
洶	汹
訩	讻
詗	诇
修	修
脩	修
鵂	鸺
饈	馐
綇	𦈋
繡	绣
鏥	𫔊
鏽	锈
吁	吁
訏	𬣙
虛	虚
須	须
頊	顼
噓	嘘
嬃	媭
諝	谞
繻	𦈡
鬚	须
許	许
詡	诩
盨	𪾔
卹	恤
恤	恤
敘	叙
漵	溆
緒	绪
銊	𫓰
續	续
鱮	𫚈
軒	轩
鋗	𫓶
諼	谖
譞	𫍽
旋	旋
璇	璇
璿	璇
懸	悬
選	选
癬	癣
絢	绚
鉉	铉
繏	𦈝
鏇	旋 镟
鞾	𫖇
學	学
嶨	峃
澩	泶
鷽	鸴
鱈	鳕
謔	谑
勛	勋
塤	埙
熏	熏
勳	勋
壎	埙
燻	熏
纁	𫄸
紃	𬘓
尋	寻
詢	询
馴	驯
鄩	𬩽
噚	㖊
潯	浔
樳	桪
燖	𬊈
璕	𬍤
蟳	𫊻
鱘	鲟
訊	讯
訓	训
遜	逊
愻	𢙏
埡	垭
椏	桠
鴉	鸦
錏	铔
鴨	鸭
壓	压
啞	哑
瘂	痖
亞	亚
軋	轧
婭	娅
掗	挜
訝	讶
氬	氩
稏	䅉
齾	𫜰
菸	烟
腌	腌
煙	烟
醃	腌
閹	阉
懨	恹
訁	讠
岩	岩
閆	闫
綖	𫄧
閻	阎
顏	颜
嚴	严
巗	𪨷
巖	岩
鹽	盐
兗	兖
噞	𪡋
縯	𬙂
厴	厣
鰋	𫚢
鶠	𬸘
龑	䶮
儼	俨
鼴	鼹
巘	𪩘
魘	魇
齴	𫜮
黶	黡
咽	咽
彥	彦
覎	觃
硯	砚
厭	厌
諺	谚
鴳	𫛩
嚥	咽
贋	赝
醶	𫑷
騴	𫘫
贗	赝
讌	䜩
饜	餍
驗	验
艷	艳
釅	酽
灧	滟
讞	谳
豔	艳
灩	滟
鉠	𫓭
鴦	鸯
陽	阳
揚	扬
暘	旸
楊	杨
煬	炀
瘍	疡
鍚	钖
颺	飏
鰑	𫚊
養	养
駚	𩧫
癢	痒
樣	样
訞	𫍚
堯	尧
軺	轺
搖	摇
遙	遥
瑤	瑶
銚	铫
嶢	峣
窯	窑
餚	肴
謠	谣
颻	飖
鰩	鳐
齩	𫜪
葯	药
藥	药
鷂	鹞
鑰	钥
爺	爷
釾	䥺
鋣	铘
叶	叶
頁	页
葉	叶
業	业
曄	晔
燁	烨
鄴	邺
謁	谒
擫	𢬍
饁	馌
靨	靥
禕	祎
銥	铱
醫	医
鷖	鹥
訑	𫍙
詑	𫍡
詒	诒
貽	贻
飴	饴
儀	仪
遺	遗
頤	颐
釔	钇
輢	𫐎
礒	𥐟
艤	舣
蟻	蚁
顗	𫖮
齮	𬺈
異	异
釴	𬬩
軼	轶
鈠	𨱁
義	义
詣	诣
勩	勚
億	亿
瘞	瘗
誼	谊
嶧	峄
憶	忆
懌	怿
瘱	𪽷
縊	缢
藝	艺
鎰	镒
繶	𫄷
繹	绎
譯	译
議	议
囈	呓
鐿	镱
鷁	鹢
鷊	鹝
驛	驿
虉	𬟁
陰	阴
絪	𬘡
蔭	荫
銦	铟
緸	𦈑
諲	𬤇
駰	骃
闉	𬮱
銀	银
誾	訚
檭	𣘴
齗	龂
鷣	𫜃
飲	饮
隱	隐
蘟	𦻕
癮	瘾
猌	𪺽
廕	荫
憖	慭
鮣	䲟
緓	绬
罃	䓨
鍈	锳
嬰	婴
應	应
嚶	嘤
孆	𫝭
孾	𪧀
攖	撄
罌	罂
櫻	樱
瓔	璎
鶯	莺
纓	缨
鷹	鹰
鸚	鹦
塋	茔
熒	荧
瑩	莹
營	营
縈	萦
螢	萤
濚	溁
瀅	滢
鎣	蓥
瀠	潆
蠅	蝇
贏	赢
潁	颍
穎	颖
頴	颕
巊	𪩎
癭	瘿
喲	哟
佣	佣
傭	佣
擁	拥
鏞	镛
鱅	鳙
癰	痈
顒	颙
鰫	𫚦
涌	涌
湧	涌
詠	咏
鯒	鲬
醟	蒏
憂	忧
優	优
郵	邮
游	游
猶	犹
遊	游
鈾	铀
蕕	莸
魷	鱿
輶	𬨎
鮋	鲉
銪	铕
誘	诱
紆	纡
于	于
余	余
於	于
娛	娱
魚	鱼
漁	渔
諛	谀
餘	余 馀
覦	觎
歟	欤
璵	玙
輿	舆
籅	𥫣
騟	𩨈
俁	俣
傴	伛
與	与
語	语
鋙	铻
嶼	屿
齬	龉
郁	郁
欲	欲
御	御
飫	饫
馭	驭
愈	愈
鈺	钰
預	预
嫗	妪
獄	狱
慾	欲
澦	滪
蕷	蓣
諭	谕
錥	𫓾
閾	阈
鴥	𫛣
禦	御
癒	愈
鵒	鹆
譽	誉
鱊	𫚪
鷸	鹬
軉	𨉗
鬱	郁
籲	吁
淵	渊
鳶	鸢
鴛	鸳
鵷	鹓
貟	贠
員	员
園	园
圓	圆
緣	缘
轅	辕
黿	鼋
櫞	橼
騵	𫘪
鶰	𫛫
遠	远
愿	愿
願	愿 𫖸
約	约
彠	彟
岳	岳
悅	悦
軏	𫐄
鈅	钥
粵	粤
鉞	钺
閱	阅
嶽	岳
躍	跃
鸑	𬸚
暈	晕
蒕	蒀
氳	氲
頵	𫖳
贇	赟
云	云
勻	匀
芸	芸
紜	纭
鄖	郧
雲	云
溳	涢
熉	𤈶
澐	沄
蕓	芸
篔	筼
鈗	𫟵
隕	陨
殞	殒
霣	𫕥
鄆	郓
惲	恽
運	运
慍	愠
腪	𣍯
熅	煴
緷	𦈉
縕	緼 缊
薀	蕰
醞	酝 醖
餫	𫗥
韞	韫
蘊	蕴 藴
韻	韵
紮	扎
鉔	𫓬
臢	臜
雜	杂
災	灾
載	载
儎	傤
攢	攒
趲	趱
暫	暂
蹔	𫏐
贊	赞
鏨	錾
酇	酂
灒	𪷽
瓚	瓒
讚	赞
贓	赃
髒	脏
駔	驵
臟	脏
鑿	凿
棗	枣
繰	缲
皁	皂
皂	皂
噪	噪
譟	噪
竈	灶
則	则
責	责
嘖	啧
幘	帻
擇	择
澤	泽
皟	𤾀
簀	箦
襗	𫋷
賾	赜
齰	𫜬
賊	贼
鯽	鲫
鰂	鲗
譖	谮
繒	缯
鋥	锃
贈	赠
扎	扎
吒	咤
閘	闸
鍘	铡
鮓	鲊
鮺	鲝
詐	诈
齋	斋
債	债
沾	沾
飦	𫗞
詀	𧮪
霑	沾
氈	毡
譫	谵
饘	𫗴
驙	𫘰
鱣	鳣
鸇	鹯
斬	斩
盞	盏
嶄	崭
颭	飐
輾	辗
占	占
佔	占
棧	栈
綻	绽
嶘	𡺄
戰	战 𢧐
驏	骣
張	张
餦	𫗠
鱆	𫠒
長	长
漲	涨
帳	帐
脹	胀
痮	𪽪
賬	账 𧹔
釗	钊
鉊	𬬿
詔	诏
趙	赵
鮡	𬶐
折	折
摺	折
輒	辄
蟄	蛰
謫	谪
鮿	𫚚
轍	辙
讋	詟
鍺	锗
襵	𫌇
這	这
鷓	鹧
貞	贞
針	针
偵	侦
楨	桢
禎	祯
鉁	𨱅
鍼	针
診	诊
軫	轸
陣	阵
紖	纼
誫	𫍨
賑	赈
鴆	鸩
鎮	镇
征	征
爭	争
崢	峥
掙	挣
猙	狰
睜	睁
鉦	钲
箏	筝
錚	铮
鯖	鲭
癥	症
症	症
幀	帧
証	证
諍	诤
鄭	郑
證	证
隻	只
梔	栀
鳷	𫛛
鴲	𪉆
織	织
執	执
跖	跖
縶	絷
職	职
蹠	跖
躑	踯
只	只
紙	纸
訨	𫟞
軹	轵
徵	征
志	志
制	制
致	致
輊	轾
滯	滞
製	制
誌	志
銍	铚
幟	帜
摯	挚
質	质
緻	致
駤	𫘠
擲	掷
櫛	栉
贄	贽
櫍	𬃊
觶	觯
騭	骘
躓	踬
鷙	鸷
鑕	锧
終	终
鈡	钟
鍾	钟 锺
鐘	钟
种	种
腫	肿
種	种
衆	众
諥	𫍳
周	周
週	周
輈	辀
銂	𫟻
賙	周 赒
輖	𫐏
謅	诌
鵃	鸼
譸	诪
軸	轴
鯞	𫚡
冑	胄
紂	纣
胄	胄
晝	昼
葤	荮
皺	皱
駎	𩧨
縐	绉
驟	骤
朱	朱
硃	朱
誅	诛
銖	铢
諸	诸
豬	猪
瀦	潴
櫫	橥
櫧	槠
築	筑
燭	烛
孎	𡠟
欘	𣚚
爥	𪹳
蠾	𧑏
詝	𬣞
劚	㔉
囑	嘱
斸	𣃁
矚	瞩
佇	伫
注	注
眝	𪾣
竚	𥩟
紵	纻
筑	筑
註	注
貯	贮
駐	驻
鑄	铸
專	专
鄟	𫑘
膞	䏝
磚	砖
諯	𫍱
顓	颛
鱄	𫚋
竱	𫁟
轉	转
賺	赚
饌	馔
囀	啭
妝	妆
莊	庄
裝	装
樁	桩
壯	壮
狀	状
戇	戆
錐	锥
騅	骓
墜	坠
綴	缀
縋	缒
贅	赘
諄	谆
准	准
準	准
綧	𬘯
梲	棁
諑	诼
濁	浊
鐯	䦃
鵫	𫛱
鐲	镯
鷟	𬸦
咨	咨
茲	兹
貲	赀
資	资
緇	缁
輜	辎
澬	𫞚
諮	咨 谘
錙	锱
鎡	镃
璾	𫞦
鯔	鲻
鰦	𫚤
釨	𫓦
眥	眦
漬	渍
綜	综
豵	𫎆
蹤	踪
騌	骔
傯	偬
總	总
糉	粽
瘲	疭
錝	𫓽
縱	纵
鄒	邹
諏	诹
鯫	鲰
騶	驺
鏃	镞
組	组
詛	诅
鑽	钻
纘	缵
纗	𫄹
鐏	𨱔
鱒	鳟
鷷	𫜄
繓	𦈛
飵	𫗢
㐹	㐹
㑮	𫝈
㑯	㑔
㑳	㑇
㑶	㐹
𠌥	𠆿
㒓	𠉂
𠏢	𠉗
𠐊	𫝋
㓄	𪠟
𠗣	㓆
㓨	刾
𠞆	𠛆
㔋	𪟎
𪟖	𠛾
𠠎	𠚳
𠬙	𪠡
㖮	𪠵
𠽃	𪠺
㗲	𠵾
㗿	𪡛
𠿕	𪜎
㘉	𠰱
𡂡	𪢒
𡃄	𪡺
𡃕	𠴛
𡃤	𪢐
㘓	𪢌
㘔	𫬐
𡄔	𠴢
𡄣	𠵸
𡅏	𠲥
𡅯	𪢖
㘚	㘎
𡑍	𫭼
𡑭	𡋗
𡓁	𪤄
𡓾	𡋀
𡔖	𡍣
㛝	𫝦
㜄	㚯
𡞵	㛟
㜏	㛣
㜐	𫝧
𡟫	𫝪
㜗	𡞋
㜢	𡞱
𡠹	㛿
𡢃	㛠
㜷	𡝠
𡮉	𡭜
𡮣	𡭬
㞞	𪨊
𡳳	𡳃
𡸗	𪨩
𡹬	𪨹
㟺	𪩇
㠏	㟆
𡽗	𡸃
㠣	𫵷
𡾱	㟜
𡿖	𪩛
㢗	𪪑
㢝	𢋈
𢍰	𪪴
㥮	㤘
㦎	𢛯
𢠼	𢙑
㦛	𢗓
㦞	𪫷
𢣐	𪬚
𢣚	𢘝
𢣭	𢘞
𢤩	𪫡
𢤱	𢘙
𢤿	𪬯
𢯷	𪭝
㨻	𪮃
㩋	𪮋
𢶒	𪭯
𢶫	𢫞
㩜	㨫
𢷮	𢫊
㩳	㧐
𢹿	𢬦
㩵	擜
𢺳	𪮳
㪎	𪯋
𩖰	𫠇
𣈶	暅
𠁞	𠀾
𣋋	𣈣
𣍐	𫧃
𣙎	㭣
㯤	𣘐
𣜬	𪳗
𣝕	𣘷
𣞻	𣘓
𣠩	𣞎
𣠲	𣑶
㰙	𣗙
𣯩	𣯣
𣯴	𣭤
𣯶	毶
㵗	𣳆
𣽏	𪶮
𣾷	㳢
𪷓	𣶭
𣿉	𣶫
㵾	𪷍
𤁣	𣺽
㶆	𫞛
𤄷	𪶒
𤅶	𣷷
㷍	𤆢
㷿	𤈷
𤑳	𤎻
𤑹	𪹀
𤒎	𤊀
𤒻	𪹹
𤓌	𪹠
𤓎	𤎺
𤓩	𤊰
𤘀	𪺣
𤛮	𤙯
𤛱	𫞢
𤜆	𪺪
㹽	𫞣
𤠮	𪺸
㺏	𤠋
㺜	𪺻
𤢟	𤝢
𤢻	𢢐
㻶	𪼋
𤩂	𫞧
𤪺	㻘
𤫩	㻏
𤬅	𪼴
𤳷	𪽝
𤳸	𤳄
𤷃	𪽭
𤸫	𤶧
𤺔	𪽴
㿖	𪽮
㿗	𤻊
㿧	𤽯
䀉	𥁢
䀹	𥅴
䁪	𥇢
𥊝	𥅿
𥌃	𥅘
䁻	䀥
䂎	𥎝
𥏝	𪿊
𥕥	𥐰
𥖅	𥐯
䃮	鿎
𥖲	𪿞
𥗇	𪿵
𥗽	𬒗
𥜐	𫀓
𥜰	𫀌
䅐	𫀨
𥞵	𥞦
䅳	𫀬
𥢢	䅪
𥢶	𫞷
𥢷	𫀮
䆉	𫁂
𥨐	𥧂
𥪂	𥩺
𥯤	𫁳
䉑	𫁲
䉙	𥬀
𥴨	𫂖
𥴼	𫁺
𥵃	𥱔
𥵊	𥭉
䉬	𫂈
𥶽	𫁱
䉲	𥮜
䉶	𫁷
𥸠	𥮋
𥻦	𫂿
𥼽	𥹥
䊭	𥺅
𥽖	𥺇
䊷	䌶
䊺	𫄚
䋃	𫄜
𥾯	𫄝
䋔	𫄞
𥿊	𦈈
䋙	䌺
䋚	䌻
䋦	𫄩
𦀖	𫄦
䋹	䌿
䋻	䌾
䋼	𫄮
䋿	𦈓
𦂅	𦈒
䌈	𦈖
䌋	𦈘
𦃄	𦈗
𦃩	𫄯
䌖	𦈜
𦅇	𫄪
𦅈	𫄵
䌝	𦈟
䌟	𦈞
䌥	𦈠
𦆲	𫟇
䌰	𦈙
䍤	𫅅
䍦	䍠
䍽	𦍠
𦒀	𫅥
䎙	𫅭
𦔖	𫅼
䎱	䎬
𦘧	𡳒
𦟼	𫆝
𦠅	𫞅
𦡝	𫆫
𦢈	𣍨
𦣎	𦟗
𦧺	𫇘
𦪙	䑽
𦪽	𦨩
䓣	𬜯
𦱌	𫇪
鿓	鿒
𦾟	𦶻
䕤	𫟕
䕳	𦰴
䖅	𫟑
䗅	𫊪
𧎈	𧌥
𧒯	𫊹
䗿	𧉞
𧔥	𧒭
𧕟	𧉐
𧜗	䘞
䙔	𫋲
𧜵	䙊
䙡	䙌
𧝞	䘛
𧞫	𫌋
𧟀	𧝧
䙱	𧜭
𧡴	𫌫
𧢄	𫌬
䚩	𫌯
䛄	𫍠
𧦝	𫍞
𧦧	𫍟
鿁	䜤
䛳	𫍫
𧩕	𫍭
𧩙	䜥
𧩼	𫍶
䜀	䜧
𧫝	𫍺
𧬤	𫍼
䜖	𫟢
𧭈	𫍾
𧭹	𫍐
𧳟	𧳕
䝭	𫎧
𧵳	䞌
𧶔	𧹓
䝻	𧹕
䝼	䞍
𧶧	䞎
𧷎	𪠀
䞈	𧹑
𧸘	𫎨
䞋	𫎪
𧹈	𪥠
䞓	𫎭
䟃	𫎺
䟆	𫎳
𧽯	𫎸
䟐	𫎱
䠆	𫏃
𨂐	𫏌
𨄣	𨀱
𨅍	𨁴
𨆪	𫏕
𨇁	𧿈
𨇞	𨅫
𨇤	𫏨
𨇰	𫏞
𨇽	𫏑
䠱	𨅛
𨈊	𨂺
𨈌	𨄄
𨊰	䢀
𨊸	䢁
𨊻	𨐆
䡐	𫟤
𨋢	䢂
𨌈	𫐍
䡩	𫟥
𨍰	𫐔
𨎌	𫐋
䡵	𫟦
𨎮	𨐉
𨏠	𨐇
𨏥	𨐊
䢨	𨑹
𨞺	𫟫
𨟊	𫟬
𨢿	𨡙
𨣈	𨡺
𨣞	𨟳
𨣧	𨠨
𨤻	𨤰
𨥛	𨱀
𨥟	𫓫
龯	𨱆
䤤	𫟺
𨦫	䦀
𨧀	𬭊
𨧜	䦁
𫒡	𫓷
𨧰	𫟽
𨧱	𨱊
𨨏	𬭛
𨨛	𫓼
𨨢	𫓿
𨩰	𫟾
䥄	𫠀
䥇	䦂
𨪕	𫓮
䥑	鿏
𨫒	𨱐
䥕	𬭯
䥗	𫔋
𨬖	𫔏
𨭆	𬭶
𨭎	𬭳
𨭖	𫔑
𨭸	𫔐
𨮂	𨱕
䥩	𨱖
𨮳	𫔒
䥯	𫔆
䥱	䥾
𨯅	䥿
𨯟	𫔓
𨰃	𫔉
𨰋	𫓳
𨰥	𫔕
𨰲	𫔃
𨲳	𫔖
𨳑	𨸁
𨳕	𨸀
䦘	𨸄
䦛	䦶
𨴗	𨸅
䦟	䦷
𨴹	𫔲
䦯	𫔵
𨵩	𨸆
𨵸	𨸇
𨶀	𨸉
𨶏	𨸊
𨶮	𨸌
𨶲	𨸋
䦳	𨷿
𨷲	𨸎
䧢	𨸟
𨼳	𫔽
𨽏	𨸘
𩀨	𫕚
𩅙	𫕨
䪊	𫖅
䪏	𩏼
𩎖	𫖑
𩎢	𩏾
𩏂	𫖓
䪗	𩐀
䪘	𩏿
𩏠	𫖖
𩏪	𩏽
𩏷	𫃗
𩑔	𫖪
䪴	𫖫
䪾	𫖬
𩒎	𫖭
䫀	𫖱
䫂	𫖰
𩓣	𩖕
𩓥	𫖵
𩔑	𫖷
䫟	𫖲
𩔳	𫖴
䫴	𩖗
䫶	𫖺
䫻	𫗇
䫾	𫠈
𩗀	𩙦
𩗓	𫗈
𩗴	𫗉
𩘀	𩙩
䬓	𫗊
䬘	𩙮
𩘝	𩙭
䬝	𩙯
𩘹	𩙨
𩘺	𩙬
𩙈	𩙰
䬞	𩙧
䬧	𫗟
𩚛	𩟿
𩚥	𩠀
𩚩	𫗡
𩚵	𩠁
𩛆	𩠂
𩛌	𫗤
䭀	𩠇
𩛡	𫗨
𩛩	𩠃
䭃	𩠈
𩜇	𩠉
𩜦	𩠆
𩜵	𩠊
𩝔	𩠋
䭑	𫗱
䭔	𫗰
𩝽	𫗳
𩞄	𩠎
𩞦	𩠏
𩞯	䭪
𩟐	𩠅
𩟗	𫗚
𩠴	𩠠
𩡣	𩡖
𩡺	𩧦
䭿	𩧭
䮄	𫠊
𩢡	𩧬
𩢴	𩧵
𩢸	𩧳
𩢾	𩧮
𩣏	𩧶
𩣑	䯃
𩣫	𩧸
𩣵	𩧻
𩣺	𩧼
𩤊	𩧩
䮝	𩧰
䮞	𩨁
䮠	𩧿
𩤙	𩨆
𩤲	𩨉
𩤸	𩨅
𩥄	𩨋
𩥇	𩨍
𩥉	𩧱
𩥑	𩨌
龭	𩨎
䮫	𩨇
䮰	𫘮
䮳	𩨏
𩦠	𫠌
𩧆	𩨐
䮾	𩧪
䯀	䯅
䯤	𩩈
𩭙	𩬣
𩯁	𫙂
𩯳	𩯒
𩰀	𩬤
𩰹	𩰰
𩳤	𩲒
𩴵	𩴌
䰾	鲃
𩵦	𫠏
𩵩	𩽺
𩵹	𩽻
䱀	𫚐
䱁	𫚏
𩶁	𫚎
𩶘	䲞
𩶰	𩽿
𩶱	𩽽
𩷰	𩾄
䱙	𩾈
䱧	𫚠
𩸃	𩾅
𩸄	𫚝
𩸡	𫚟
𩸦	𩾆
䱬	𩾊
䱰	𩾋
䱷	䲣
䱸	𫠑
䱽	䲝
䲁	鳚
䲅	𫚜
𩻗	𫚨
𩻬	𫚩
𩻮	𫚘
䲖	𩾂
䲘	鳤
𩼶	𫚬
𩽇	𩾎
䲰	𪉂
𩿅	𫠖
𩿤	𫛠
𩿪	𪉄
𪀖	𫛧
𪀦	𪉅
𪀾	𪉋
𪁈	𪉉
䳜	𫛬
𪁖	𪉌
䳢	𫛰
䳤	𫛮
𪂆	𪉎
䳧	𫛺
䳫	𫛼
𪃍	𪉐
𪃏	𪉏
𪃒	𫛻
𪃧	𫛹
𪄆	𪉔
𪄕	𪉒
𪅂	𫜂
䴉	鹮
䴋	𫜅
𪆷	𫛾
𪇳	𪉕
𪈼	𱊜
𪉸	𫜊
𪋿	𫧮
䴬	𪎈
䴱	𫜒
䴴	𪎋
𪌭	𫜓
䴽	𫜔
𪍠	𫜕
䵳	𪑅
䵴	𫜙
𪓰	𫜟
𪔵	𪔭
䶕	𫜨
𪘀	𪚏
𫜦	𫜫
𪘯	𪚐
𪙏	𫜯
䶲	𫜳
