锕	錒
挨	捱
锿	鎄
皑	皚
嗳	噯
蔼	藹
霭	靄
爱	愛
嫒	嬡
碍	礙
叆	靉
暧	曖
瑷	璦
庵	菴
谙	諳
鹌	鵪
𩽾	鮟
铵	銨
暗	闇
肮	骯
鳌	鰲
袄	襖
媪	媼
奥	奧
骜	驁
鲃	䰾
钯	鈀
坝	垻 壩
罢	罷
鲅	鮁
摆	擺 襬
败	敗
颁	頒
阪	阪
坂	阪
板	闆
钣	鈑
办	辦
绊	絆
帮	幫
绑	綁
谤	謗
镑	鎊
龅	齙
宝	寶
饱	飽
鸨	鴇
报	報
铇	鉋
鲍	鮑
杯	盃
鹎	鵯
贝	貝
𬇙	浿
狈	狽
备	備
钡	鋇
惫	憊
辈	輩
呗	唄
贲	賁
锛	錛
绷	綳 繃
镚	鏰
鲾	鰏
笔	筆
币	幣
毕	畢
闭	閉
诐	詖
哔	嗶
荜	蓽
毙	斃
铋	鉍
筚	篳
赑	贔
滗	潷
跸	蹕
边	邊
笾	籩
编	編
鳊	鯿
贬	貶
变	變
缏	緶
辩	辯
辫	辮
标	標
飑	颮
骉	驫
骠	驃
镖	鏢
飙	飆
飚	飈
镳	鑣
表	錶
鳔	鰾
鳖	鱉
别	別 彆
瘪	癟
宾	賓
傧	儐
滨	濱
缤	繽
槟	檳
瑸	璸
镔	鑌
濒	瀕
摈	擯
殡	殯
膑	臏
髌	髕
鬓	鬢
饼	餅
禀	稟
并	並 併
拨	撥
剥	剝
钵	缽 鉢
饽	餑
𬭛	𨨏
驳	駁
袯	襏
钹	鈸
铂	鉑
鹁	鵓
馎	餺
鲌	鮊
镈	鎛
卜	蔔
钸	鈽
补	補
𬷕	鵏
布	佈
钚	鈈
才	纔
财	財
采	埰 寀 採
彩	綵
参	參 蔘
骖	驂
残	殘
蚕	蠶
惭	慚
惨	慘
䅟	穇
黪	黲
灿	燦
仓	倉
伧	傖
沧	滄
苍	蒼
鸧	鶬
舱	艙
册	冊
侧	側
厕	厠 廁
恻	惻
测	測
荝	萴
层	層
馇	餷
锸	鍤
查	査
镲	鑔
诧	詫
姹	奼
钗	釵
侪	儕
虿	蠆
觇	覘
掺	摻
搀	攙
婵	嬋
谗	讒
禅	禪
馋	饞
缠	纏
蝉	蟬
镡	鐔
镵	鑱
产	產 産
浐	滻
谄	諂
啴	嘽
铲	剷 鏟
阐	闡
𬊤	燀
蒇	蕆
骣	驏
冁	囅
忏	懺
刬	剗
颤	顫
伥	倀
阊	閶
锠	錩
鲳	鯧
肠	腸
苌	萇
尝	嘗 嚐
偿	償
鲿	鱨
厂	廠
场	場
𬬮	鋹
怅	悵
畅	暢
钞	鈔
鼌	鼂
车	車
伡	俥
砗	硨
彻	徹
𬘭	綝
尘	塵
陈	陳
谌	諶
碜	磣
衬	襯
龀	齔
榇	櫬
谶	讖
柽	檉
称	稱
蛏	蟶
赪	赬
撑	撐
枨	棖
诚	誠
铖	鋮
惩	懲
骋	騁
吃	喫
彨	彲
𫄨	絺
鸱	鴟
痴	癡
驰	馳
迟	遲
齿	齒
耻	恥
饬	飭
炽	熾
冲	沖 衝
虫	蟲
宠	寵
铳	銃
俦	儔
帱	幬
绸	綢
畴	疇
筹	籌
踌	躊
雠	讎
丑	醜
出	齣
䝙	貙
刍	芻
厨	廚
锄	鋤
雏	雛
橱	櫥
蹰	躕
础	礎
储	儲
𬺓	齼
处	處
绌	絀
触	觸
传	傳
钏	釧
疮	瘡
床	牀
闯	闖
创	創
怆	愴
锤	錘 鎚
䲠	鰆
纯	純
唇	脣
莼	蒓 蓴
𬭚	錞
鹑	鶉
绰	綽
辍	輟
龊	齪
词	詞
辞	辭
鹚	鶿 鷀
糍	餈
𫚖	鮆
刾	㓨
赐	賜
囱	囪
苁	蓯
枞	樅
葱	蔥
骢	驄
聪	聰
从	從
丛	叢
凑	湊
辏	輳
撺	攛
镩	鑹
蹿	躥
窜	竄
缞	縗
鹾	鹺
锉	銼
错	錯
哒	噠
𨱏	鎝
达	達
荙	薘
𫟼	鐽
鞑	韃
垯	墶
跶	躂
呆	獃
轪	軑
绐	紿
骀	駘
带	帶
贷	貸
叇	靆
单	單
担	擔
郸	鄲
殚	殫
瘅	癉
箪	簞
𬘘	紞
胆	膽
掸	撣
赕	賧
诞	誕
𫢸	僤
弹	彈
惮	憚
当	噹 當
珰	璫
裆	襠
铛	鐺
筜	簹
挡	擋
党	黨
谠	讜
𣗋	欓
砀	碭
垱	壋
荡	盪 蕩
档	檔
𬍡	璗
鱽	魛
导	導
岛	島
陦	隯
捣	搗 擣
祷	禱
盗	盜
锝	鍀
灯	燈
邓	鄧
镫	鐙
䃅	磾
镝	鏑
籴	糴
敌	敵
涤	滌
𬱖	頔
觌	覿
诋	詆
抵	牴
牴	牴
递	遞
谛	諦
缔	締
䗖	螮
颠	顛
巅	巔
癫	癲
点	點
电	電
垫	墊
钿	鈿
淀	澱
雕	彫 琱 鵰
鲷	鯛
吊	弔
钓	釣
窎	窵
调	調
铞	銱
铫	銚
绖	絰
谍	諜
𫶇	嵽
叠	疊
鲽	鰈
钉	釘
顶	頂
订	訂
饤	飣
锭	錠
丢	丟
铥	銩
东	東
冬	鼕
岽	崬
鸫	鶇
𬟽	蝀
动	動
冻	凍
栋	棟
胨	腖
钭	鈄
斗	鬥
饾	餖
窦	竇
阇	闍
独	獨
读	讀
渎	瀆
椟	櫝
牍	牘
犊	犢
黩	黷
笃	篤
赌	賭
𬭊	𨧀
镀	鍍
断	斷
缎	緞
锻	鍛
簖	籪
队	隊
对	對
兑	兌
怼	懟
吨	噸
镦	鐓
趸	躉
炖	燉
钝	鈍
顿	頓
夺	奪
铎	鐸
敚	敓
缍	綞
亸	嚲
饳	飿
堕	墮
讹	訛
锇	鋨
鹅	鵝
额	額
轭	軛
垩	堊
恶	噁 惡
饿	餓
谔	諤
𫫇	噁
腭	齶
锷	鍔
鹗	鶚
颚	顎
擜	㩵
鳄	鰐 鱷
诶	誒
儿	兒
鸸	鴯
鲕	鮞
尔	爾
迩	邇
饵	餌
铒	鉺
贰	貳
发	發 髮
罚	罰
阀	閥
珐	琺
矾	礬
钒	釩
烦	煩
𫔍	鐇
𬸪	鷭
泛	氾 汎
饭	飯
范	範
贩	販
钫	鈁 鍅
鲂	魴
仿	彷
访	訪
纺	紡
飞	飛
绯	緋
𬴂	騑
鲱	鯡
诽	誹
废	廢
费	費
镄	鐨
纷	紛
坟	墳
𣸣	濆
豮	豶
奋	奮
偾	僨
愤	憤
粪	糞
鲼	鱝
丰	豐
风	風
沣	灃
沨	渢
枫	楓
疯	瘋
砜	碸
峰	峯
锋	鋒
冯	馮
讽	諷
凤	鳳
缝	縫
赗	賵
肤	膚
𫓧	鈇
麸	麩
凫	鳧 鳬
佛	彿
绂	紱
绋	紼
韨	韍
辐	輻
呒	嘸
抚	撫
辅	輔
𫖯	頫
讣	訃
妇	婦
负	負
驸	駙
复	復 複 覆
赋	賦
缚	縛
鲋	鮒
赙	賻
鳆	鰒
覆	覆
钆	釓
该	該
赅	賅
钙	鈣
𬮿	隑
盖	蓋
杆	桿
尴	尷
秆	稈
赶	趕
鳡	鱤
干	乾 幹 榦
绀	紺
赣	贛
冈	岡
刚	剛
纲	綱
㭎	棡
钢	鋼
岗	崗
杠	槓
戆	戇
缟	縞
镐	鎬
诰	誥
锆	鋯
鸽	鴿
搁	擱
阁	閣
镉	鎘
个	個 箇
铬	鉻
给	給
亘	亙
搄	揯
赓	賡
鹒	鶊
绠	綆
鲠	鯁
暅	𣈶
宫	宮
龚	龔
巩	鞏
贡	貢
沟	溝
钩	鈎 鉤
缑	緱
鞲	韝
构	構
诟	詬
购	購
够	夠
觏	覯
轱	軲
鸪	鴣
诂	詁
谷	穀
钴	鈷
蛊	蠱
馉	餶
鹄	鵠
毂	轂
鹘	鶻
顾	顧
雇	僱
锢	錮
鲴	鯝
刮	颳
鸹	鴰
剐	剮
诖	詿
挂	掛
掴	摑
拐	枴 柺
关	關
观	觀
鳏	鰥
馆	舘 館
鳤	䲘
贯	貫
惯	慣
掼	摜
鹳	鸛
𨐈	輄
广	廣
犷	獷
归	歸
妫	媯 嬀
龟	龜
规	規
闺	閨
椝	槼
鲑	鮭
鬶	鬹
轨	軌
匦	匭
诡	詭
刽	劊
刿	劌
柜	櫃
贵	貴
桧	檜
椢	槶
鳜	鱖
衮	袞
绲	緄
辊	輥
滚	滾
鲧	鯀
呙	咼
埚	堝
啯	嘓
锅	鍋
蝈	蟈
国	國
帼	幗
𬇹	漍
腘	膕
馃	餜
椁	槨
过	過
铪	鉿
还	還
骇	駭
顸	頇
韩	韓
㘎	㘚
汉	漢
闬	閈
颔	頷
绗	絎
颃	頏
蚝	蠔
号	號
颢	顥
灏	灝
诃	訶
合	閤
纥	紇
阂	閡
饸	餄
核	覈
龁	齕
颌	頜
阖	闔
鲄	魺
鹖	鶡
贺	賀
鹤	鶴
𬭶	𨭆
𬣳	詪
恒	恆
鸻	鴴
横	橫
轰	轟
哄	鬨
红	紅
纮	紘
闳	閎
荭	葒
𫟹	鉷
鸿	鴻
𬭎	鋐
黉	黌
唝	嗊
讧	訌
𬭤	鍭
糇	餱
后	後
鲎	鱟
鲘	鮜
轷	軤
戯	戱
胡	衚 鬍
壶	壺
鹕	鶘
糊	餬
浒	滸
户	戶
护	護
沪	滬
鹱	鸌
鳠	鱯
哗	嘩 譁
华	華
骅	驊
铧	鏵
划	劃 畫
画	畫 畵
话	話
桦	樺
婳	嫿
怀	懷
坏	壞
欢	歡
环	環
𬘫	綄
锾	鍰
缳	繯
阛	闤
𤩽	瓛
镮	鐶
鹮	䴉
缓	緩
奂	奐
唤	喚
换	換
涣	渙
焕	煥
痪	瘓
鲩	鯇
黄	黃
锽	鍠
𨱑	鐄
鳇	鰉
谎	謊
㧑	撝
诙	詼
挥	揮
袆	褘
晖	暉
翚	翬
辉	輝
回	迴
毁	毀 燬 譭
汇	匯 彙 滙
会	會
讳	諱
哕	噦
浍	澮
绘	繪
荟	薈
诲	誨
烩	燴
贿	賄
秽	穢
缋	繢
翙	翽
阓	闠
颒	頮
𬤝	譓
𬭬	鏏
荤	葷
阍	閽
浑	渾
珲	琿
馄	餛
诨	諢
𬴃	騞
锪	鍃
伙	夥
钬	鈥
夥	夥
货	貨
获	獲 穫
祸	禍
镬	鑊
讥	譏
击	擊
叽	嘰
饥	飢 饑
机	機
玑	璣
矶	磯
鸡	雞 鷄
𬯀	隮
积	積
𫓯	銈
缉	緝
赍	賫 齎
𫌀	襀
跻	躋
𫓹	錤
齑	齏
羁	羈
级	級
即	卽
极	極
辑	輯
鹡	鶺
藉	藉
几	幾
虮	蟣
挤	擠
鱾	魢
计	計
记	記
纪	紀
际	際
剂	劑
哜	嚌
既	旣
济	濟
荠	薺
迹	跡 蹟
𪟝	勣
继	繼
觊	覬
绩	績
蓟	薊
霁	霽
鲚	鱭
鲫	鯽
𬶨	鱀
骥	驥
𬶭	鰶
夹	夾
浃	浹
家	傢
𬂩	梜
镓	鎵
郏	郟
荚	莢
铗	鋏
蛱	蛺
颊	頰
贾	賈
钾	鉀
槚	檟
价	價
驾	駕
戋	戔
奸	姦
坚	堅
歼	殲
间	間
艰	艱
监	監
笺	箋
缄	緘
缣	縑
鲣	鰹
鹣	鶼
篯	籛
鞯	韉
鳒	鰜
拣	揀
枧	梘
俭	儉
茧	繭
捡	撿
笕	筧
减	減
检	檢
睑	瞼
硷	礆
裥	襇 襉
锏	鐧
简	簡
谫	謭 譾
戬	戩
碱	鹼
见	見
𬣡	諓
饯	餞
剑	劍
荐	薦
贱	賤
涧	澗
舰	艦
渐	漸
谏	諫
溅	濺
践	踐
鉴	鑑 鑒
键	鍵
姜	薑
将	將
浆	漿
僵	殭
螀	螿
缰	繮 韁
鳉	鱂
讲	講
奖	奬 獎
桨	槳
蒋	蔣
绛	絳
酱	醬
娇	嬌
浇	澆
骄	驕
胶	膠
鲛	鮫
䴔	鵁
鹪	鷦
侥	僥
挢	撟
绞	絞
饺	餃
矫	矯
脚	腳
铰	鉸
搅	攪
缴	繳
峤	嶠
轿	轎
较	較
教	敎
阶	階
疖	癤
节	節
讦	訐
杰	傑
诘	詰
洁	潔
结	結
颉	頡
鲒	鮚
届	屆
诫	誡
借	藉
钅	釒
𬬱	釿
仅	僅
尽	儘 盡
侭	儘
卺	巹
紧	緊
谨	謹
锦	錦
馑	饉
劲	勁
进	進
浕	濜
荩	藎
晋	晉
烬	燼
赆	贐
琎	璡
缙	縉
觐	覲
泾	涇
经	經
茎	莖
荆	荊
惊	驚
鲸	鯨
䴖	鶄
刭	剄
颈	頸
净	凈 淨
弪	弳
径	徑
迳	逕
胫	脛
痉	痙
竞	競
靓	靚
静	靜
镜	鏡
𬳶	駉
䌹	絅
颎	熲
纠	糾
鸠	鳩
阄	鬮
旧	舊
厩	廄
鹫	鷲
驹	駒
锔	鋦
𬶋	鮈
局	侷
䴗	鶪
举	舉
矩	榘
榉	櫸 欅
龃	齟
巨	鉅
讵	詎
钜	鉅
剧	劇
惧	懼
据	據
飓	颶
锯	鋸
窭	窶
屦	屨
鹃	鵑
镌	鎸 鐫
卷	捲
锩	錈
绢	絹
隽	雋
决	決
诀	訣
𫘝	駃
绝	絕 絶
觉	覺
谲	譎
镢	鐝 钁
𫔎	鐍
军	軍
钧	鈞
皲	皸
鲪	鮶
俊	儁
馂	餕
骏	駿
开	開
锎	鐦
凯	凱
剀	剴
垲	塏
恺	愷
闿	闓
铠	鎧
锴	鍇
忾	愾
龛	龕
槛	檻
阚	闞
𩾌	鱇
闶	閌
钪	鈧
铐	銬
鲓	鮳
轲	軻
疴	痾
钶	鈳
颏	頦
颗	顆
壳	殻 殼
克	剋
课	課
骒	騍
缂	緙
锞	錁
剋	剋
垦	墾
恳	懇
硁	硜
铿	鏗
𫸩	彄
抠	摳
眍	瞘
扣	釦
库	庫
绔	絝
喾	嚳
裤	褲
夸	誇
㧟	擓
块	塊
侩	儈
郐	鄶
哙	噲
狯	獪
脍	膾
鲙	鱠
宽	寬
髋	髖
诓	誆
诳	誑
𫛭	鵟
邝	鄺
圹	壙
纩	纊
况	況
旷	曠
矿	礦
贶	貺
亏	虧
岿	巋
窥	窺
骙	騤
𫠆	頍
匮	匱
愦	憒
溃	潰
蒉	蕢
馈	饋
瞆	瞶
篑	簣
聩	聵
昆	崑
裈	褌
锟	錕
鹍	鵾
鲲	鯤
捆	綑
阃	閫
壸	壼
困	睏
扩	擴
阔	闊
腊	臘
蜡	蠟
𬶟	鯻
镴	鑞
来	來
俫	倈
崃	崍
徕	徠
涞	淶
莱	萊
梾	棶
铼	錸
赉	賚
睐	睞
赖	賴
濑	瀨
癞	癩
籁	籟
兰	蘭
岚	嵐
拦	攔
栏	欄
阑	闌
蓝	藍
𬒗	𥗽
谰	讕
澜	瀾
褴	襤
斓	斕
篮	籃
襕	襴
镧	鑭
览	覽
揽	攬
缆	纜
榄	欖
懒	懶
烂	爛
滥	濫
锒	鋃
阆	閬
捞	撈
劳	勞
唠	嘮
𫭼	𡑍
崂	嶗
痨	癆
铹	鐒
铑	銠
涝	澇
耢	耮
乐	樂
鳓	鰳
了	瞭
饹	餎
缧	縲
蔂	虆
镭	鐳
诔	誄
垒	壘
泪	淚
类	類
累	纍
颣	纇
棱	稜
厘	釐
离	離
骊	驪
鹂	鸝
漓	灕
缡	縭
蓠	蘺
鲡	鱺
篱	籬
礼	禮
里	裏 裡
逦	邐
锂	鋰
鲤	鯉
鳢	鱧
历	厤 曆 歷
厉	厲
丽	麗
励	勵
呖	嚦
坜	壢
𫵷	㠣
沥	瀝
苈	藶
枥	櫪
疠	癘
隶	隸
俪	儷
栎	櫟
𬍛	瓅
疬	癧
轹	轢
郦	酈
栗	慄
砺	礪
砾	礫
莅	蒞
粝	糲
蛎	蠣
跞	躒
雳	靂
俩	倆
奁	奩
连	連
帘	簾
怜	憐
涟	漣
莲	蓮
梿	槤
联	聯
裢	褳
鲢	鰱
镰	鎌 鐮
敛	斂
琏	璉
脸	臉
裣	襝
蔹	蘞
练	練
炼	煉 鍊
恋	戀
殓	殮
链	鍊 鏈
潋	瀲
𬶠	鰊
凉	涼
梁	樑
𫟅	綡
辌	輬
粮	糧
两	兩
唡	啢
𬜯	䓣
魉	魎
谅	諒
辆	輛
辽	遼
疗	療
缭	繚
鹩	鷯
钌	釕
瞭	瞭
镣	鐐
猎	獵
䴕	鴷
𫚭	鱲
邻	鄰
临	臨
𬴊	驎
辚	轔
𬭸	鏻
鳞	鱗
凛	凜
廪	廩
懔	懍
檩	檁
赁	賃
蔺	藺
躏	躪
灵	靈
凌	淩
铃	鈴
鸰	鴒
棂	欞
绫	綾
龄	齡
鲮	鯪
岭	嶺
领	領
刘	劉
浏	瀏
馏	餾
骝	騮
飗	飀
镏	鎦
鹠	鶹
镠	鏐
绺	綹
锍	鋶
鹨	鷚
龙	龍
咙	嚨
泷	瀧
茏	蘢
昽	曨
栊	櫳
珑	瓏
胧	朧
眬	矓
砻	礱
笼	籠
聋	聾
陇	隴
垄	壟
垅	壠
拢	攏
𬕂	篢
䁖	瞜
娄	婁
偻	僂
喽	嘍
𪣻	塿
溇	漊
蒌	蔞
楼	樓
耧	耬
蝼	螻
髅	髏
嵝	嶁
搂	摟
篓	簍
瘘	瘺 瘻
镂	鏤
噜	嚕
撸	擼
卢	盧
庐	廬
芦	蘆
垆	壚
泸	瀘
炉	爐
栌	櫨
胪	臚
轳	轤
𬬻	鑪
鸬	鸕
舻	艫
颅	顱
鲈	鱸
卤	滷 鹵
虏	虜
掳	擄
硵	磠
鲁	魯
澛	瀂
橹	櫓
镥	鑥
陆	陸
录	彔 錄 録
赂	賂
辂	輅
渌	淥
𫘧	騄
禄	祿
箓	籙
辘	轆
鹭	鷺
氇	氌
驴	驢
闾	閭
榈	櫚
𦝼	膢
吕	呂
侣	侶
铝	鋁
屡	屢
缕	縷
褛	褸
穞	穭
虑	慮
绿	綠 緑
滤	濾
娈	孌
孪	孿
峦	巒
挛	攣
栾	欒
鸾	鸞
脔	臠
滦	灤
銮	鑾
乱	亂
锊	鋝
抡	掄
仑	侖 崙
伦	倫
囵	圇
沦	淪
纶	綸
轮	輪
𬬭	錀
𫭢	埨
论	論
啰	囉
罗	羅
猡	玀
脶	腡
萝	蘿
逻	邏
椤	欏
锣	鑼
箩	籮
骡	騾
镙	鏍
泺	濼
络	絡
荦	犖
骆	駱
妈	媽
马	馬
犸	獁
玛	瑪
码	碼
蚂	螞
杩	榪
祃	禡
骂	罵 駡
吗	嗎
买	買
荬	蕒
劢	勱
迈	邁
麦	麥
卖	賣
脉	脈
唛	嘜
鿏	䥑
霡	霢
颟	顢
蛮	蠻
馒	饅
瞒	瞞
鳗	鰻
满	滿
螨	蟎
𬜬	蔄
谩	謾
缦	縵
镘	鏝
铓	鋩
猫	貓
牦	氂 犛
锚	錨
铆	鉚
贸	貿
么	麼 麽
没	沒
镅	鎇
鹛	鶥
霉	黴
镁	鎂
门	門
扪	捫
钔	鍆
𫞩	璊
闷	悶
焖	燜
懑	懣
们	們
𫑡	鄳
蒙	懞 濛 矇
鹲	鸏
锰	錳
梦	夢
弥	彌 瀰
祢	禰
猕	獼
谜	謎
芈	羋
觅	覓
秘	祕
幂	冪
谧	謐
绵	綿
渑	澠
缅	緬
腼	靦
𩾃	鮸
面	麪 麫 麵
麺	麪 麵
鹋	鶓
缈	緲
庙	廟
灭	滅
蔑	衊
缗	緡
闵	閔
黾	黽
闽	閩
悯	憫
鳘	鰵
鸣	鳴
铭	銘
谬	謬
谟	謨
馍	饃
麽	麼 麽
嬷	嬤
殁	歿
蓦	驀
镆	鏌
𬙊	纆
谋	謀
缪	繆
亩	畝
𬭁	鉧
钼	鉬
镎	錼 鎿
呐	吶
纳	納
钠	鈉
难	難
馕	饢
挠	撓
铙	鐃
蛲	蟯
垴	堖
恼	惱
脑	腦
闹	鬧
讷	訥
馁	餒
内	內
铌	鈮
𫐐	輗
鲵	鯢
𫠜	齯
拟	擬
腻	膩
鲇	鮎
鲶	鯰
辇	輦
撵	攆
念	唸
娘	孃
酿	釀
鸟	鳥
茑	蔦
袅	嫋 裊
陧	隉
聂	聶
啮	嚙 齧
嗫	囁
𫔶	闑
镊	鑷
镍	鎳
颞	顳
蹑	躡
蘖	櫱
宁	寧 甯
咛	嚀
拧	擰
狞	獰
苧	薴
柠	檸
聍	聹
泞	濘
纽	紐
钮	鈕
农	農
侬	儂
哝	噥
浓	濃
脓	膿
秾	穠
𬪩	醲
驽	駑
钕	釹
疟	瘧
傩	儺
诺	諾
锘	鍩
讴	謳
𫭟	塸
欧	歐
殴	毆
瓯	甌
鸥	鷗
呕	嘔
𬉼	熰
怄	慪
沤	漚
盘	盤
蹒	蹣
厐	龎
彷	彷
庞	龐
鳑	鰟
抛	拋
疱	皰
赔	賠
锫	鉳 錇
辔	轡
喷	噴
鹏	鵬
纰	紕
𬳵	駓
铍	鈹
鲏	鮍
罴	羆
辟	闢
䴙	鸊
骈	駢
谝	諞
骗	騙
缥	縹
飘	飄
𬭯	䥕
贫	貧
嫔	嬪
频	頻
𬞟	蘋
颦	顰
评	評
凭	憑
苹	蘋
鲆	鮃
钋	釙
泼	潑
颇	頗
酦	醱
䥽	鏺
钷	鉕
仆	僕
扑	撲
镤	鏷
朴	樸
谱	譜
镨	鐠
铺	鋪
凄	悽 淒
栖	棲
桤	榿
戚	慼
齐	齊
祇	祇
𬨂	軝
脐	臍
颀	頎
埼	碕
骐	騏
骑	騎
棋	棊
蛴	蠐
锜	錡
旗	旂
蕲	蘄
鲯	鯕
鳍	鰭
岂	豈
启	啓 啟
绮	綺
气	氣
讫	訖
弃	棄
碛	磧
千	韆
迁	遷
佥	僉
钎	釺
牵	牽
悭	慳
铅	鉛
谦	謙
签	簽 籤
骞	騫
鹐	鵮
钤	鈐
钱	錢
钳	鉗
乾	乾
潜	潛
浅	淺
谴	譴
缱	繾
伣	俔
堑	塹
𬘬	綪
椠	槧
呛	嗆
戗	戧
枪	槍
玱	瑲
锖	錆
锵	鏘
镪	鏹
强	強
墙	墻 牆
嫱	嬙
蔷	薔
樯	檣
抢	搶
羟	羥
炝	熗
跄	蹌
硗	磽
跷	蹺
锹	鍬
缲	繰
乔	喬
侨	僑
荞	蕎
桥	橋
硚	礄
谯	譙
鞒	鞽
诮	誚
窍	竅
翘	翹
窃	竊
惬	愜
箧	篋
锲	鍥
亲	親
钦	欽
骎	駸
嵚	嶔
锓	鋟
寝	寢
揿	撳
氢	氫
轻	輕
倾	傾
鲭	鯖
顷	頃
请	請
庼	廎
庆	慶
穷	窮
茕	煢
䓖	藭
琼	瓊
秋	鞦
鹙	鶖
鳅	鰍
虬	虯
赇	賕
巯	巰
𨱇	銶
区	區
曲	麯 麴
岖	嶇
诎	詘
驱	驅
躯	軀
趋	趨
麹	麴
鸲	鴝
龋	齲
阒	闃
觑	覷
权	權
诠	詮
辁	輇
铨	銓
鳈	鰁
颧	顴
绻	綣
劝	勸
阙	闕
却	卻
𬒈	礐
悫	愨 慤
确	確
阕	闋
鹊	鵲
群	羣
让	讓
娆	嬈
荛	蕘
饶	饒
桡	橈
扰	擾
绕	繞
热	熱
认	認
讱	訒
纫	紉
纴	紝
轫	軔
韧	韌
饪	飪
驲	馹
绒	絨
荣	榮
嵘	嶸
蝾	蠑
镕	鎔
𫐓	輮
铷	銣
颥	顬
缛	縟
软	軟
锐	銳 鋭
闰	閏
润	潤
挲	挱
洒	灑
钑	鈒
飒	颯
萨	薩
鳃	鰓
赛	賽
叁	叄
毵	毿
毶	𣯶
伞	傘
糁	糝
馓	饊
颡	顙
丧	喪
骚	騷
缫	繅
鳋	鰠
扫	掃
涩	澀
啬	嗇
铯	銫
穑	穡
椮	槮
杀	殺
纱	紗
刹	剎
铩	鎩
榝	樧
鲨	鯊
厦	廈
筛	篩
晒	曬
删	刪
姗	姍
钐	釤
膻	羶
闪	閃
陕	陝
讪	訕
𫮃	墠
椫	樿
骟	騸
缮	繕
赡	贍
鳝	鱔
伤	傷
殇	殤
觞	觴
赏	賞
绱	緔 鞝
烧	燒
绍	紹
𪨶	輋
赊	賒
舍	捨
厍	厙
设	設
慑	懾
摄	攝
滠	灄
谁	誰
绅	紳
诜	詵
𬳽	駪
鲹	鰺
𬬹	鉮
沈	瀋
审	審
谂	諗
谉	讅
婶	嬸
渖	瀋
肾	腎
渗	滲
瘆	瘮
升	昇 陞
声	聲
绳	繩
圣	聖
胜	勝
尸	屍
师	師
虱	蝨
诗	詩
鸤	鳲
浉	溮
狮	獅
湿	溼 濕
酾	釃
𫚕	鰤
䴓	鳾
鲺	鯴
饣	飠
时	時
识	識
实	實
蚀	蝕
埘	塒
莳	蒔
鲥	鰣
驶	駛
势	勢
视	視
试	試
饰	飾
贳	貰
适	適
轼	軾
铈	鈰
𬤊	諟
弑	弒
谥	諡 謚
释	釋
寿	壽
兽	獸
绶	綬
书	書
纾	紓
枢	樞
摅	攄
输	輸
赎	贖
属	屬
术	朮 術
树	樹
竖	竪 豎
𬬸	鉥
数	數
帅	帥
闩	閂
双	雙
骦	驦
鹴	鸘
涚	涗
税	稅
顺	順
说	說 説
烁	爍
铄	鑠
硕	碩
纟	糹
丝	絲
私	俬
咝	噝
鸶	鷥
缌	緦
蛳	螄
飔	颸
厮	廝
锶	鍶
饲	飼
驷	駟
松	鬆
㧐	㩳
怂	慫
耸	聳
讼	訟
诵	誦
颂	頌
搜	蒐
馊	餿
飕	颼
锼	鎪
擞	擻
薮	藪
苏	囌 甦 蘇
稣	穌
诉	訴
肃	肅
𫗧	餗
骕	驌
谡	謖
溯	泝 遡
鹔	鷫
酸	痠
虽	雖
绥	綏
随	隨
岁	嵗 歲 𡻕
谇	誶
𫟦	䡵
𬭼	鐩
孙	孫
狲	猻
荪	蓀
飧	飱
损	損
笋	筍
蓑	簑
缩	縮
唢	嗩
琐	瑣
锁	鎖
铊	鉈
鿎	䃮
獭	獺
鳎	鰨
挞	撻
闼	闥
阘	闒
台	檯 臺 颱
苔	薹
鲐	鮐
薹	薹
态	態
钛	鈦
贪	貪
摊	攤
滩	灘
瘫	癱
坛	墰 壇 壜 罈 罎
昙	曇
谈	談
锬	錟
谭	譚
钽	鉭
叹	嘆 歎
汤	湯
铴	鐋
镗	鏜
糖	醣
傥	儻
镋	鎲 钂
烫	燙
涛	濤
绦	絛 縧
焘	燾
韬	韜
梼	檮
绹	綯
𫘦	騊
讨	討
铽	鋱
腾	騰
誊	謄
䲢	鰧
锑	銻
䴘	鷉
绨	綈
缇	緹
𫘨	騠
鹈	鵜
题	題
鳀	鯷
体	體
屉	屜
靔	靝
阗	闐
觍	覥
条	條
龆	齠
鲦	鰷
粜	糶
贴	貼
铁	鐵
厅	廳
听	聽
烃	烴
𬘩	綎
铤	鋌
颋	頲
同	衕
𫍣	詷
铜	銅
鲖	鮦
统	統
恸	慟
头	頭
秃	禿
图	圖
涂	塗
𬳿	駼
钍	釷
团	團 糰
抟	摶
𬯎	隤
颓	頹 頽
蜕	蛻
饨	飩
鲀	魨
讬	託
托	託
饦	飥
捝	挩
脱	脫
驮	馱
驼	駝
鸵	鴕
𬶍	鮀
鼍	鼉
椭	橢
萚	蘀
箨	籜
洼	窪
娲	媧
袜	襪
腽	膃
弯	彎
塆	壪
湾	灣
纨	紈
玩	翫
顽	頑
挽	輓
绾	綰
万	萬
𬇕	澫
网	網
辋	輞
鳂	鰃
韦	韋
围	圍
帏	幃
沩	溈 潙
𣲗	湋
违	違
闱	闈
涠	潿
维	維
潍	濰
𬶏	鮠
伟	偉
伪	偽 僞
纬	緯
苇	葦
𬀩	暐
炜	煒
玮	瑋
𫇭	蒍 蔿
诿	諉
𬱟	頠
韪	韙
鲔	鮪
卫	衛
为	為 爲
硙	磑
谓	謂
喂	餵
猬	蝟
鳚	䲁
温	溫
榅	榲
辒	輼 轀
蕰	薀
鳁	鰛 鰮
纹	紋
𫘜	馼
闻	聞
阌	閿
稳	穩
问	問
揾	搵
𬭩	鎓
鹟	鶲
瓮	甕
挝	撾
涡	渦
莴	萵
窝	窩
蜗	蝸
卧	臥
龌	齷
乌	烏
污	汙
邬	鄔
呜	嗚
诬	誣
钨	鎢
无	無
吴	吳
芜	蕪
铻	鋙
鹀	鵐
妩	嫵
庑	廡
怃	憮
𣲘	潕
鹉	鵡
务	務
坞	塢
误	誤
悮	悞
骛	騖
雾	霧
鹜	鶩
饻	餏
牺	犧
锡	錫
习	習
席	蓆
袭	襲
觋	覡
𫘬	騱
鳛	鰼
玺	璽
铣	銑
𬭳	𨭎
𬶮	鱚
戏	戲
屃	屓
系	係 繫
饩	餼
细	細
绤	綌
阋	鬩
虾	蝦
侠	俠
峡	峽
狭	狹
硖	硤
辖	轄
吓	嚇
纤	縴 纖
籼	秈
莶	薟
铦	銛
跹	躚
锨	鍁
鲜	鮮
𬸣	鶱
闲	閑 閒
弦	絃
贤	賢
咸	鹹
挦	撏
娴	嫺 嫻
衔	銜
𫍯	諴
痫	癇
鹇	鷳 鷴
狝	獮
显	顯
险	險
崄	嶮
猃	獫
蚬	蜆
藓	蘚
县	縣
岘	峴
苋	莧
𬀪	晛
现	現
线	綫 線
宪	憲
𪾢	睍
馅	餡
缐	線
羡	羨
献	獻
乡	鄉
芗	薌
厢	廂
缃	緗
𬙋	纕
骧	驤
镶	鑲
详	詳
响	響
蚃	蠁
饷	餉
飨	饗
鲞	鮝 鯗
向	嚮 曏
项	項
枭	梟
哓	嘵
骁	驍
绡	綃
鸮	鴞
萧	蕭
销	銷
潇	瀟
箫	簫
蟏	蠨
嚣	囂
晓	曉
𫍲	謏
筿	篠
啸	嘯
敩	斆
蝎	蠍
协	協
胁	脅
挟	挾
谐	諧
携	攜
撷	擷
缬	纈
写	寫
泄	洩
泻	瀉
绁	紲
亵	褻
谢	謝
𬹼	齘
䜣	訢
𫷷	廞
锌	鋅
衅	釁
骍	騂
饧	餳
陉	陘
𫰛	娙
荥	滎
钘	鈃
铏	鉶
兴	興
幸	倖
凶	兇
讻	訩
汹	洶
诇	詗
修	脩
鸺	鵂
馐	饈
绣	綉 繡
锈	銹 鏽
𬣙	訏
吁	籲
须	須 鬚
顼	頊
虚	虛
谞	諝
媭	嬃
嘘	噓
𦈡	繻
许	許
诩	詡
叙	敘
恤	卹
绪	緒
续	續
溆	漵
轩	軒
谖	諼
𫓶	鋗
𫍽	譞
𫠊	䮄
悬	懸
旋	鏇
璇	璿
选	選
癣	癬
绚	絢
铉	鉉
镟	鏇
学	學
峃	嶨
泶	澩
鸴	鷽
鳕	鱈
谑	謔
勋	勛 勳
埙	塤 壎
熏	燻
𫄸	纁
寻	尋
𬘓	紃
询	詢
浔	潯
荨	蕁
𬩽	鄩
桪	樳
𬊈	燖
𬍤	璕
鲟	鱘
训	訓
讯	訊
驯	馴
逊	遜
压	壓
垭	埡
鸦	鴉
桠	椏
鸭	鴨
铔	錏
哑	啞
痖	瘂
轧	軋
亚	亞
讶	訝
娅	婭
挜	掗
氩	氬
恹	懨
烟	煙 菸
阉	閹
阏	閼
腌	醃
讠	訁
闫	閆
严	嚴
岩	巖
盐	鹽
𫄧	綖
阎	閻
颜	顏 顔
兖	兗
俨	儼
䶮	龑
厣	厴
𬙂	縯
𬸘	鶠
魇	魘
𪩘	巘
黡	黶
鼹	鼴
厌	厭
觃	覎
咽	嚥
彦	彥
砚	硯
艳	艷 豔
验	驗
谚	諺
滟	灧 灩
酽	釅
谳	讞
餍	饜
赝	贋 贗
鸯	鴦
扬	揚
阳	陽
旸	暘
杨	楊
炀	煬
玚	瑒
飏	颺
疡	瘍
钖	鍚
养	養
痒	癢
样	樣
尧	堯
肴	餚
峣	嶢
轺	軺
窑	窯
谣	謠 謡
摇	搖
遥	遙
瑶	瑤
飖	颻
鳐	鰩
药	葯 藥
钥	鈅 鑰
鹞	鷂
爷	爺
铘	鋣
业	業
叶	葉
页	頁
邺	鄴
晔	曄
烨	燁
谒	謁
馌	饁
靥	靨
医	醫
祎	禕
铱	銥
鹥	鷖
仪	儀
诒	詒
饴	飴
贻	貽
遗	遺
颐	頤
钇	釔
舣	艤
蚁	蟻
𫖮	顗
𬺈	齮
义	義
亿	億
忆	憶
艺	藝
议	議
异	異
呓	囈
译	譯
峄	嶧
怿	懌
绎	繹
诣	詣
𬬩	釴
驿	驛
轶	軼
谊	誼
勚	勩
缢	縊
瘗	瘞
镒	鎰
鹝	鷊
鹢	鷁
𫄷	繶
𬟁	虉
镱	鐿
阴	陰
𬘡	絪
荫	廕 蔭
骃	駰
𬤇	諲
铟	銦
𬮱	闉
訚	誾
银	銀
龂	齗
龈	齦
饮	飲
隐	隱
瘾	癮
慭	憖
䲟	鮣
应	應
莺	鶯
婴	嬰
绬	緓
䓨	罃
锳	鍈
嘤	嚶
撄	攖
缨	纓
罂	罌
樱	櫻
璎	瓔
鹦	鸚
鹰	鷹
茔	塋
荧	熒
莹	瑩
萤	螢
营	營
萦	縈
溁	濚
滢	瀅
蓥	鎣
潆	瀠
蝇	蠅
赢	贏
颍	潁
颕	頴
颖	穎
瘿	癭
哟	喲
佣	傭
拥	擁
痈	癰
镛	鏞
鳙	鱅
颙	顒
咏	詠
涌	湧
踊	踴
鲬	鯒
优	優
忧	憂
犹	猶
邮	郵
莸	蕕
铀	鈾
游	遊
鱿	魷
𬨎	輶
鲉	鮋
铕	銪
诱	誘
蒏	醟
纡	紆
于	於
余	餘
欤	歟
玙	璵
於	於
鱼	魚
娱	娛
谀	諛
馀	餘
渔	漁
逾	踰
觎	覦
舆	輿
与	與
伛	傴
屿	嶼
俣	俁
语	語
龉	齬
驭	馭
妪	嫗
饫	飫
郁	鬱
狱	獄
钰	鈺
预	預
欲	慾
谕	諭
阈	閾
御	禦
鹆	鵒
愈	癒
滪	澦
蓣	蕷
誉	譽
鹬	鷸
鸢	鳶
鸳	鴛
渊	淵
鹓	鵷
贠	貟
员	員
园	園
圆	圓
缘	緣
鼋	黿
𫘪	騵
辕	轅
橼	櫞
远	遠
愿	願
约	約
彟	彠
𫐄	軏
岳	嶽
悦	悅
钺	鉞
阅	閱 閲
跃	躍
粤	粵
𬸚	鸑
晕	暈
蒀	蒕
氲	氳
煴	熅
𫖳	頵
赟	贇
云	雲
匀	勻
沄	澐
纭	紜
芸	蕓
郧	鄖
涢	溳
筼	篔
陨	隕
殒	殞
运	運
郓	鄆
恽	惲
酝	醖 醞
愠	慍
缊	緼 縕
韫	韞
韵	韻
蕴	藴 蘊
臜	臢
杂	雜
灾	災
载	載
傤	儎
攒	攢
趱	趲
暂	暫
赞	讚 贊
錾	鏨
酂	酇
瓒	瓚
赃	贓 贜
驵	駔
脏	臟 髒
凿	鑿
枣	棗
灶	竈
皂	皁
噪	譟
则	則
择	擇
泽	澤
责	責
啧	嘖
帻	幘
箦	簀
赜	賾
贼	賊
鲗	鰂
谮	譖
缯	繒
锃	鋥
赠	贈
扎	紮
闸	閘
铡	鍘
鲊	鮓
鲝	鮺
诈	詐
咤	吒
栅	柵
斋	齋
债	債
沾	霑
毡	氈
谵	譫
𫗴	饘
鹯	鸇
鳣	鱣
斩	斬
飐	颭
盏	盞
崭	嶄
辗	輾
占	佔
战	戰
栈	棧
绽	綻
张	張
长	長
涨	漲
帐	帳
胀	脹
账	賬
钊	釗
𬬿	鉊
诏	詔
赵	趙
𬶐	鮡
折	摺
辄	輒
蛰	蟄
詟	讋
谪	謫
辙	轍
锗	鍺
这	這
鹧	鷓
贞	貞
针	針 鍼
侦	偵
帧	幀
浈	湞
桢	楨
真	眞
祯	禎
诊	診
轸	軫
缜	縝
阵	陣
纼	紖
鸩	鴆
赈	賑
镇	鎭 鎮
争	爭
征	徵
峥	崢
挣	掙
狰	猙
钲	鉦
睁	睜
铮	錚
筝	箏
证	証 證
诤	諍
郑	鄭
症	癥
织	織
栀	梔
执	執
职	職
絷	縶
跖	蹠
踯	躑
只	祇 衹 隻
纸	紙
衹	衹
轵	軹
徵	徵
志	誌
制	製
帜	幟
质	質
栉	櫛
挚	摯
致	緻
贽	贄
轾	輊
掷	擲
铚	銍
鸷	鷙
𬃊	櫍
滞	滯
骘	騭
锧	鑕
觯	觶
踬	躓
终	終
钟	鈡 鍾 鐘
锺	鍾
肿	腫
种	種
冢	塚
众	眾 衆
诌	謅
周	週
诪	譸
辀	輈
鸼	鵃
赒	賙
轴	軸
纣	紂
㑇	㑳
㤘	㥮
绉	縐
昼	晝
胄	冑
荮	葤
皱	皺
骤	驟
朱	硃
诛	誅
诸	諸
猪	豬
铢	銖
槠	櫧
潴	瀦
橥	櫫
烛	燭
𬣞	詝
嘱	囑
瞩	矚
伫	佇
纻	紵
苎	苧
注	註
贮	貯
驻	駐
筑	築
铸	鑄
专	專
䏝	膞
砖	磚
颛	顓
转	轉
啭	囀
赚	賺
馔	饌
妆	妝
庄	莊
桩	樁
装	裝
壮	壯
状	狀
骓	騅
锥	錐
坠	墜
缀	綴
缒	縋
赘	贅
谆	諄
准	準
𬘯	綧
棁	梲
䦃	鐯
浊	濁
诼	諑
𬸦	鷟
镯	鐲
兹	茲
咨	諮
赀	貲
资	資
缁	緇
谘	諮
辎	輜
锱	錙
镃	鎡
龇	齜
鲻	鯔
渍	漬
眦	眥
综	綜
骔	騌
踪	蹤
总	總
偬	傯
纵	縱
疭	瘲
粽	糉
邹	鄒
驺	騶
诹	諏
鲰	鯫
镞	鏃
诅	詛
组	組
钻	鉆 鑽
躜	躦
缵	纘
𨱔	鐏
鳟	鱒
𠀾	𠁞
𪜎	𠿕
㐷	傌
㐹	㑶
㐽	偑
𠆿	𠌥
㑈	倲
𠇹	俓
㑔	㑯
𫝈	㑮
𠉂	㒓
𠉗	𠏢
㑩	儸
𠋆	儭
𫝋	𠐊
㓆	𠗣
𪞝	凙
𠚳	𠠎
𠛅	剾
𠛆	𠞆
㓥	劏
𠛾	𪟖
㓰	劃
𪟎	㔋
㔉	劚
𠡠	勑
𫧃	𣍐
𫧮	𪋿
𪠀	𧷎
𪠟	㓄
𪠡	𠬙
𠮶	嗰
𠯟	哯
𠯠	噅
𪠳	唓
𪠵	㖮
𠰱	㘉
𠰷	嚧
𪠸	嚛
㖊	噚
𠱞	囃
𠲥	𡅏
𪠺	𠽃
𪠽	噹
𪡀	嘺
𪡃	嘪
㖞	喎
𠴛	𡃕
𠴢	𡄔
𪡋	噞
𠵸	𡄣
𠵾	㗲
𪡏	嗹
𪡛	㗿
𪡞	嘳
𪡺	𡃄
𪢌	㘓
𪢐	𡃤
𪢒	𡂡
𪢕	嚽
𪢖	𡅯
𫬐	㘔
𪢠	囒
𪢮	圞
𪢸	墲
𪣆	埬
𡋀	𡓾
𡋗	𡑭
𡋤	壗
𪣒	堚
𡍣	𡔖
𪤄	𡓁
𪤚	壣
𡒄	壈
𪥠	𧹈
㚯	㜄
㛠	𡢃
𪥫	孇
𫝦	㛝
㛀	媰
𪥰	嬣
𫝧	㜐
𫝨	媈
㛟	𡞵
㛣	㜏
㛤	孋
𫝩	嬦
𫝪	𡟫
𫝫	婡
𡝠	㜷
𡞋	㜗
𪥿	嬻
㛿	𡠹
𡞱	㜢
𫝬	嬇
𡠟	孎
𫝭	孆
𫝮	孄
𡥧	孻
𪧀	孾
𪧘	寠
𡭜	𡮉
𡭬	𡮣
𪨊	㞞
𪨗	屩
𡳃	𡳳
𡳒	𦘧
𪨧	崙
𪨩	𡸗
㟆	㠏
𡶴	嵼
𡸃	𡽗
𪨷	巗
𪨹	𡹬
𫝵	嶹
㟜	𡾱
㟥	嵾
𡺃	嶈
𡺄	嶘
𪩇	㟺
𪩎	巊
𪩛	𡿖
㡎	幓
𪩷	幝
𪩸	幩
𠆲	儣
𪪏	廬
𪪑	㢗
𪪞	廧
𢋈	㢝
𪪴	𢍰
𪪼	彃
𪫌	徿
𢗓	㦛
𪫡	𢤩
𢘙	𢤱
𢘝	𢣚
𢘞	𢣭
𢙏	愻
𢙐	憹
𢙑	𢠼
𢙒	憢
𢙓	懀
㤽	懤
𪫷	㦞
𪫺	憸
𢛯	㦎
㥪	慺
𪬚	𢣐
𢠁	懎
𢢐	𤢻
𪬯	𢤿
𢧐	戰
㧏	掆
𪭝	𢯷
𪭢	摐
𢫊	𢷮
𢫞	𢶫
𪭧	擟
㧰	擽
𢫬	摋
𢬍	擫
𢬦	𢹿
𪭯	𢶒
𢭏	擣
𪭵	掚
𪭾	撊
𪮃	㨻
𪮋	㩋
𪮖	撧
㨫	㩜
𪮳	𢺳
𪮶	攋
𪯋	㪎
𢽾	斅
𣃁	斸
𣆐	曥
𣈣	𣋋
𪰶	曊
𫞅	𦠅
𪱥	膹
𣎑	臗
㭏	椲
𣏢	槫
𪱷	梖
𣐕	桱
𣐤	欍
㭣	𣙎
㭤	樢
𣑶	𣠲
𪲎	櫅
㭴	樫
𣒌	楇
𪲔	欐
𪲛	檵
𣓿	橯
𣔌	樤
𪲮	櫠
𣗊	樠
𣗙	㰙
𣘐	㯤
𣘓	𣞻
𪳍	欇
𪳗	𣜬
𣘴	檭
𣘷	𣝕
𣚚	欘
𣞎	𣠩
𪴙	欑
㱩	殰
㱮	殨
𣨼	殢
𪵑	毊
𣭤	𣯴
𣯣	𣯩
𪵣	霼
𣱝	氭
㲿	瀇
㳔	濧
㳕	灡
𣳆	㵗
𪵱	濿
㳠	澾
㳡	濄
㳢	𣾷
𪶄	溡
𫞗	潣
㳽	瀰
㴋	潚
𣶩	澅
𣶫	𣿉
𣶭	𪷓
𣷷	𤅶
𪶒	𤄷
𣺼	灙
𣺽	𤁣
𪶮	𣽏
𫞚	澬
𫞛	㶆
𣽷	瀃
𪷍	㵾
𫞝	灍
㶉	鸂
𪷽	灒
𤆡	熓
𤆢	㷍
𪸕	熂
𤇃	爄
𤇄	熌
𤇭	爖
㶶	燶
𤇹	熚
𪸩	煇
㶽	煱
𤈶	熉
𤈷	㷿
𫞠	爧
𤊀	𤒎
𤊰	𤓩
𪹀	𤑹
𤋏	熡
𪹠	𤓌
𫞡	爃
𤎺	㸇 𤓎
𤎻	𤑳
𪹳	爥
𪹹	𤒻
𪺣	𤘀
𪺪	𤜆
𫞢	𤛱
𪺭	犞
𤙯	𤛮
𪺷	獊
𤝢	𤢟
𪺸	𤠮
𫞣	㹽
𤞃	獩
𪺻	㺜
𤞤	玁
𪺽	猌
𤠋	㺏
㺍	獱
𪻐	瑽
𫞥	珼
㻅	璯
𫞦	璾
㻏	𤫩
㻘	𤪺
𤦀	瓕
𪻨	瓄
𪻲	瑻
𫞧	𤩂
𪻺	璝
𪼋	㻶
𫞨	璼
𪼴	𤬅
𪽈	畼
𤳄	𤳸
𪽝	𤳷
𪽪	痮
𪽭	𤷃
𪽮	㿖
𤶊	癐
𤶧	𤸫
𪽴	𤺔
𪽷	瘱
𤻊	㿗
𤽯	㿧
𤾀	皟
𤿲	麬
𥁢	䀉
𪾔	盨
𪾣	眝
䀥	䁻
𥅘	𥌃
𪾦	矑
𥅴	䀹
𥅿	𥊝
𥆧	瞤
𥇢	䁪
𪾸	矉
𥎝	䂎
𪿊	𥏝
𥐟	礒
𥐯	𥖅
𥐰	𥕥
𥐻	碙
䂵	碽
𪿞	𥖲
𪿫	礮
𪿵	𥗇
𫀌	𥜰
𫀓	𥜐
𫀨	䅐
𫀬	䅳
䅉	稏
𥞦	𥞵
𫀮	𥢷
𫞷	𥢶
䅪	𥢢
𫁂	䆉
𥧂	𥨐
𥩟	竚
𫁟	竱
𫁡	鴗
𥩺	𥪂
𥫣	籅
𫁱	𥶽
𥬀	䉙
𫁲	䉑
𫁳	𥯤
𫁷	䉶
𥬞	籋
𥬠	篘
𫁺	𥴼
䇲	筴
𥭉	𥵊
𥮋	𥸠
𫂃	簢
𥮜	䉲
𥮾	篸
𫂆	簂
𫂈	䉬
𥱔	𥵃
𫂖	𥴨
䉤	籔
𥹥	𥼽
𫂿	𥻦
𥺅	䊭
𥺇	𥽖
𫃗	𩏷
𫄙	糺
䌶	䊷
䌸	縳
𫄚	䊺
𫄛	紟
𫄜	䋃
𫄝	𥾯
䌷	紬
𦈈	𥿊
𫄞	䋔
𫄟	絁
䌺	䋙
䌻	䋚
𦈉	緷
𫄠	絙
𫄡	絧
𫄢	絥
𫄣	繷
𫟃	絍
䌼	綐
𦈋	綇
𦈌	綀
𫄤	繨
𫄥	纚
𫄦	𦀖
𫄩	䋦
𫟄	綋
䌽	綵
𦈎	繟
𦈏	緍
𦈐	縺
𫄪	𦅇
𫄫	綟
䌾	䋻
䌿	䋹
𦈑	緸
𦈒	𦂅
𦈓	䋿
𦈔	縎
𦈕	緰
𫄬	緤
𫄭	緮
𫄮	䋼
𫟆	緟
䍀	繿
𦈖	䌈
𦈗	𦃄
𦈘	䌋
𦈙	䌰
𫄯	𦃩
𫄰	縍
𦈚	縬
𫄱	繬
𫄲	縸
𫄳	縰
𫄴	繂
𦈛	繓
𦈜	䌖
𦈝	繏
𫄵	𦅈
𫄶	繈
𰬸	繐
䍁	繸
𦈞	䌟
𦈟	䌝
𦈠	䌥
𫟇	𦆲
𫄹	纗
𫅅	䍤
䍠	䍦
𦍠	䍽
𫅗	羵
𫅥	𦒀
𫅭	䎙
𫅼	𦔖
䎬	䎱
𫆏	聻
𣍨	𦢈
𣍯	腪
𣍰	脥
𫆝	𦟼
𦛨	朥
𦟗	𦣎
𫆫	𦡝
𫇘	𦧺
𦨩	𦪽
𫇛	艣
䑽	𦪙
𫇪	𦱌
𰰨	菕
𫇴	蒭
鿒	鿓
𫇽	蕽
䓓	薵
𦰏	蓧
𫈉	蕳
𫈎	葝
𫟑	䖅
䓕	薳
𦰴	䕳
𫈟	蔯
𫈵	蕝
𦶟	爇
𦶻	𦾟
𫉁	薆
𫉄	藷
𫟕	䕤
𦻕	蘟
𧉐	𧕟
𫊪	䗅
𧉞	䗿
𫊮	蠦
𫊸	蟜
𫊹	𧒯
𫊻	蟳
𧌥	𧎈
𫋇	蟂
𫋌	蟘
𧏖	蠙
𧏗	蠀
𧑏	蠾
𧒭	𧔥
䘛	𧝞
䘞	𧜗
𫋲	䙔
𫋷	襗
𫋹	襓
𫋻	襘
䙊	𧜵
䙌	䙡
䙓	襬
𫌇	襵
𫌋	𧞫
𧜭	䙱
𧝝	襰
𧝧	𧟀
𫌨	覼
𫌪	覛
𫌫	𧡴
𫌬	𧢄
𫌭	覹
𫌯	䚩
𫍙	訑
𫍚	訞
𫍛	訜
𫟞	訨
𧮪	詀
𫍜	詓
𫍝	諫
𫍞	𧦝
𫍟	𧦧
𫍠	䛄
𫍡	詑
𫟟	詊
䜤	鿁
𫍢	譊
𫍤	譑
𫍥	誂
𫍦	譨
𫍧	誺
𫍨	誫
𫍩	諣
𫍪	誋
䜥	𧩙
𫍫	䛳
𫍬	誷
𫍭	𧩕
𫍮	誳
𫟠	譂
𫟡	誴
𫍰	諰
𫍱	諯
𫍳	諥
𫍴	謱
䜧	䜀
𫍵	謸
𫍶	𧩼
𫍷	謉
𫍸	謆
𫟢	䜖
𫍹	謯
𫍺	𧫝
𫍻	譆
𫍼	𧬤
𫍐	𧭹
𫍾	𧭈
𰶎	譅
𫍿	譾
䜩	讌
𫎆	豵
𧳕	𧳟
𫎌	貗
𧹑	䞈
𧹒	買
𫎦	贚
𫎧	䝭
䞌	𧵳
𧹓	𧶔
𫎨	𧸘
䞍	䝼
䞎	𧶧
𧹕	䝻
𧹖	賟
𫎩	賝
䞐	賰
𫎪	䞋
𧹗	贃
𫎫	贉
𫎬	贑
𫎭	䞓
𫎱	䟐
𫎳	䟆
𫎸	𧽯
𫎺	䟃
𧿈	𨇁
𫏃	䠆
䟢	躎
𨀁	躘
𫏆	蹳
𨀱	𨄣
𫏋	蹻
𨁴	𨅍
𫏌	𨂐
𫏐	蹔
𫏑	𨇽
𨂺	𨈊
𫏕	𨆪
𨄄	𨈌
𫏞	𨇰
𨅛	䠱
𨅫	𨇞
𨅬	躝
𫏨	𨇤
𨉗	軉
䢀	𨊰
𫐅	軕
䢁	𨊸
𨐅	軗
𨐆	𨊻
𫐆	轣
𫐇	軜
䢂	𨋢
𨐇	𨏠
𫐈	軷
𫐉	軨
𫐊	軬
𫟤	䡐
𫐋	𨎌
𫐌	軿
𫐍	𨌈
𫐎	輢
𫐏	輖
𫐑	輨
𫐒	輷
𫐔	𨍰
𫟥	䡩
𫐕	轊
𫐖	轇
𨐉	𨎮
𫐗	轐
𫐘	轗
𫐙	轠
𨐊	𨏥
𨑹	䢨
𫐷	遱
𫑘	鄟
𫟫	𨞺
𫟬	𨟊
𨟳	𨣞
𨠨	𨣧
𫑷	醶
𨡙	𨢿
𨡺	𨣈
𨤰	𨤻
𫓥	釟
𫟲	釚
𨰾	鎷
𨰿	釳
𫓦	釨
𫟳	釲
䥺	釾
𨱀	𨥛
𨱁	鈠
𨱂	鈋
𫓨	鈛
𫓩	鏦
𫓪	鈆
𫓫	𨥟
𫟴	鈖
𫟵	鈗
䥾	䥱
䥿	𨯅
𨱃	鈲
𨱄	鈯
𨱅	鉁
𨱆	龯
𫓬	鉔
𫓭	鉠
𫓮	𨪕
𫟶	銏
𫟷	鉝
䦀	𨦫
𫓰	銊
𫓱	鐈
𫓲	銁
𫓳	𨰋
𫓴	鉾
𫟸	鉽
𫟺	䤤
𫟻	銂
䦁	𨧜
𨱈	鋉
𫓵	鋠
𫓷	𫒡
𰾄	鋂
𨱉	鍄
𨱊	𨧱
𨱋	錂
𨱌	鏆
𫓸	錽
𫓺	鐪
𫓻	錜
𫓼	𨨛
𫓽	錝
𫓾	錥
𫓿	𨨢
𫟽	𨧰
𨱎	鍮
𫔀	鍊
𫔁	鐼
𫔂	鍉
𫔃	𨰲
𫔄	鍒
𫟾	𨩰
𫟿	鎈
鿔	鎶
䦂	䥇
𨱍	鎯
𫔅	鎍
𫔆	䥯
𫔇	鎞
𫔈	鎙
𫠀	䥄
𰾭	鑀
𨱐	𨫒
𨱒	鏉
𫔉	𨰃
𫔊	鏥
𬭭	鏚
䦅	鐥
𨱓	鐎
𫔋	䥗
𫔌	鏾
𫔏	𨬖
𨱕	𨮂
𨱖	䥩
𫔐	𨭸
𫔑	𨭖
𫔒	𨮳
𫠁	鑉
𫔓	𨯟
𫔔	鑴
𫔕	𨰥
䦆	钁
𫔖	𨲳
𨷿	䦳
𨸀	𨳕
𨸁	𨳑
𨸂	閍
𨸃	閐
𫔭	開
𫔮	閒
𫔯	閗
𫔰	閞
𫠂	閝
䦶	䦛
𨸄	䦘
𨸅	𨴗
䦷	䦟
𫔲	𨴹
𫔴	閵
𨸆	𨵩
𨸇	𨵸
𨸉	𨶀
𨸊	𨶏
𫔵	䦯
𨸋	𨶲
𨸌	𨶮
𨸎	𨷲
𨸘	𨽏
𨸟	䧢
𫔽	𨼳
𫕚	𩀨
𫕥	霣
𫕨	𩅙
䩄	靦
𫖃	靧
𫖅	䪊
𫖇	鞾
𩏼	䪏
𫖑	𩎖
𩏽	𩏪
𩏾	𩎢
𫖒	韠
𫖓	𩏂
𩏿	䪘
𩐀	䪗
𫠅	韚
𫖔	韛
𫖕	韝
𫖖	𩏠
𫖪	𩑔
𫖫	䪴
𫖬	䪾
𫖭	𩒎
𫖰	䫂
𫖱	䫀
𩓋	顂
𫖲	䫟
𩖕	𩓣
𩖖	顃
𫖴	𩔳
𫖵	𩓥
𫖶	顅
𫖷	𩔑
𫖸	願
𫖹	顣
𩖗	䫴
𫖺	䫶
𫗇	䫻
𫠇	𩖰
𩙥	颰
𩙦	𩗀
𫠈	䫾
𩙧	䬞
𫗈	𩗓
𩙨	𩘹
𩙩	𩘀
𩙪	颷
𫗉	𩗴
𩙫	颾
𩙬	𩘺
𫗊	䬓
𩙭	𩘝
𩙮	䬘
𩙯	䬝
𩙰	𩙈
𫗋	飋
𫗞	飦
𩟿	𩚛
𩠀	𩚥
𫗟	䬧
𫗠	餦
𩠁	𩚵
𩠂	𩛆
𫗡	𩚩
𫗢	飵
𫗣	飶
𩠃	𩛩
𫗤	𩛌
𫗥	餫
𩠅	𩟐
𩠇	䭀
𫗦	餔
𫗨	𩛡
𩠆	𩜦
𩠈	䭃
𩠉	𩜇
𫗩	饠
𫗪	餧
𩠊	𩜵
𩠋	𩝔
𫗫	餬
𫗬	餪
𫗭	餵
𫗮	餭
𫗯	餱
𩠌	餸
𫗰	䭔
𫗱	䭑
𫗚	𩟗
𩠎	𩞄
䭪	𩞯
𩠏	𩞦
𫗳	𩝽
𫗵	饟
𩠠	𩠴
𩡖	𩡣
𫘛	馯
𩧦	𩡺
𩧨	駎
𩧩	𩤊
𩧪	䮾
𩧫	駚
𩧬	𩢡
𩧭	䭿
𩧯	驋
𫘞	駞
𫘟	駊
䯃	𩣑
𩧮	𩢾
𩧰	䮝
𩧱	𩥉
𩧲	駧
𩧳	𩢸
𩧴	駩
𩧵	𩢴
𩧶	𩣏
𫘠	駤
𫘡	駫
䯄	騧
𩧸	𩣫
𩧺	駶
𫘣	駻
𫘤	騃
𩧻	𩣵
𩧼	𩣺
𫘥	騉
𩧿	䮠
𩨀	騔
𩨁	䮞
𩨂	驄
𩨃	騝
𩨅	𩤸
𩨆	𩤙
𩨇	䮫
𩨈	騟
𩨉	𩤲
𩨊	騚
𫘩	騜
䯅	䯀
𩨄	騪
𩨋	𩥄
𩨌	𩥑
𩨍	𩥇
𫘫	騴
𫘭	騻
𫘮	䮰
𫠋	騼
𩨎	龭
𩨏	䮳
𫘯	驓
𫘰	驙
𫠌	𩦠
𩨐	𩧆
𫘱	驨
𩩈	䯤
𩬣	𩭙
𩬤	𩰀
𫘽	鬠
𩭹	鬖
𫙂	𩯁
𩯒	𩯳
𩰰	𩰹
𩲒	𩳤
𩴌	𩴵
𫚈	鱮
𫚉	魟
𫚊	鰑
䲝	䱽
𩽹	魥
𩽺	𩵩
𩽻	𩵹
𫚋	鱄
𫚌	魦
𫚍	魵
𫠏	𩵦
䲞	𩶘
𫚎	𩶁
𫚏	䱁
𫚐	䱀
𫚑	鮅
𫚒	鮄
𫠐	魽
𩽼	鯶
𩽽	𩶱
𩽿	𩶰
𫚓	鮤
𫚔	鮰
𫚗	鮯
𫚘	𩻮
𩾁	鯄
𩾂	䲖
𩾄	𩷰
𫚙	鯆
𫚚	鮿
𫚛	鮵
𩾅	𩸃
𩾆	𩸦
𩾇	鯱
𩾈	䱙
𫚜	䲅
𫚝	𩸄
𫚞	鯬
𫚟	𩸡
𫚠	䱧
𫚡	鯞
䲡	鰌
𩾊	䱬
𩾋	䱰
𫚢	鰋
𫚣	鯾
𫚤	鰦
𫚥	鰕
𫠑	䱸
䲣	䱷
𫚦	鰫
𫚧	鰽
𫚨	𩻗
𫠒	鱆
𫚩	𩻬
𫚪	鱊
𫚫	鱢
𫚬	𩼶
𩾎	𩽇
𪉂	䲰
𪉃	鳼
𫛚	鳽
𫛛	鳷
𫛜	鴀
𫛝	鴅
𫛞	鴃
𫠖	𩿅
𪉄	𩿪
𫛟	鸗
𫛠	𩿤
𫛡	鴔
𫛢	鸋
𫛣	鴥
𫛤	鴐
𪉅	𪀦
𪉆	鴲
𪉈	鴜
𪉉	𪁈
𪉊	鷨
𪉋	𪀾
𫛥	鵊
𫛦	鴮
𫛧	𪀖
𫛨	鵧
𫛩	鴳
𫛪	鴽
𪉌	𪁖
𪉍	鵚
𫛫	鶰
𫛬	䳜
𫛮	䳤
𫛯	鶭
𪉎	𪂆
𫛰	䳢
𫛱	鵫
𫛲	鵰
𫛳	鵩
𫛴	鷤
𫛵	鶌
𪉏	𪃏
𪉐	𪃍
𫛶	鶒
𫛷	鶦
𫛸	鶗
𫛹	𪃧
𫛺	䳧
𫛻	𪃒
𫛼	䳫
𪉑	鷔
𪉒	𪄕
𪉔	𪄆
𫛽	鷅
𫛾	𪆷
𱊜	𪈼
𫜀	鷐
𫜁	鷩
𫜂	𪅂
𫜃	鷣
𫜄	鷷
𫜅	䴋
𬸯	鷿
𪉕	𪇳
𫜊	𪉸
𪎈	䴬
𪎉	麲
𪎊	麨
𫜑	麷
𪎋	䴴
𫜒	䴱
𪎌	麳
𫜓	𪌭
𫜔	䴽
𫜕	𪍠
𪑅	䵳
𫜙	䵴
𫜟	𪓰
𪔭	𪔵
𫜨	䶕
𪚏	𪘀
𫜩	齧
𫜪	齩
𫜫	𫜦
𪚐	𪘯
𫜬	齰
𫜭	齭
𫜮	齴
𫜯	𪙏
𫜰	齾
𫜲	龓
𫜳	䶲
