八濛山	八濛山
拜复	拜覆
毕昇	畢昇
变徵	變徵
变徵之声	變徵之聲
变徵之音	變徵之音
禀复	稟覆
不了解	不瞭解
朝乾夕惕	朝乾夕惕
沉船	沈船
沉积	沈積
沉没	沈沒
沉没成本	沈沒成本
沉默	沈默
筹划	籌畫
出丑狼藉	出醜狼藉
答复	答覆
大目乾连冥间救母变文	大目乾連冥間救母變文
荡复	蕩覆
抵触	牴觸
抵牾	牴牾
颠倒乾坤	顛倒乾坤
颠乾倒坤	顛乾倒坤
电复	電覆
貂复额	貂覆額
笃麽	篤麼
锻锺	鍛鍾
二𫫇英	二噁英
发复	發覆
樊於期	樊於期
反反复复	反反覆覆
反复	反覆
反复思量	反覆思量
反复思维	反覆思維
反复性	反覆性
仿佛	彷彿
复按	覆按
复杯	覆杯
复瓿	覆瓿
复成	覆成
复呈	覆呈
复帱	覆幬
复电	覆電
复鼎	覆鼎
复醢	覆醢
复酱瓿	覆醬瓿
复蕉寻鹿	覆蕉尋鹿
复鹿寻蕉	覆鹿尋蕉
复鹿遗蕉	覆鹿遺蕉
复露	覆露
复冒	覆冒
复命	覆命
复墓	覆墓
复逆	覆逆
复上	覆上
复文	覆文
复校	覆校
复信	覆信
复盂	覆盂
复育	覆育
复帐	覆帳
复住	覆住
复宗	覆宗
覆盘	覆盤
覆盆	覆盆
覆盆子	覆盆子
干干脆脆	乾乾脆脆
干干净净	乾乾淨淨
宫商角徵羽	宫商角徵羽
顾借	顧藉
郭子乾	郭子乾
函复	函覆
狐借虎威	狐藉虎威
壶里乾坤	壺裏乾坤
滑借	滑藉
黄锺公	黄鍾公
回复	回覆
藉藉	藉藉
藉藉无名	藉藉无名
计划	計畫
家具	傢俱
简单明了	簡單明瞭
见复	見覆
角徵	角徵
角徵羽	角徵羽
铰链	鉸鍊
借草枕块	藉草枕塊
借词	藉詞
借此	藉此
借此机会	藉此機會
借代	藉代
借读	藉讀
借端	藉端
借端生事	藉端生事
借方	藉方
借槁	藉槁
借故	藉故
借故推辞	藉故推辭
借卉	藉卉
借机	藉機
借据	藉據
借口	藉口
借寇兵	藉寇兵
借寇兵赍盗粮	藉寇兵齎盜糧
借甚	藉甚
借手	藉手
借条	藉條
借以	藉以
借由	藉由
借喻	藉喻
借着	藉着
借助	藉助
借助于	藉助於
借箸代筹	藉箸代籌
借资	藉資
金链	金鍊
金吒	金吒
颈链	頸鍊
酒逢知己千锺少	酒逢知己千鍾少
酒逢知己千锺少话不投机半句多	酒逢知己千鍾少話不投機半句多
钜防	鉅防
钜万	鉅萬
钜子	鉅子
据了解	據瞭解
钧复	鈞覆
康乾	康乾
拉链	拉鍊
拉链工程	拉鍊工程
浪荡乾坤	浪蕩乾坤
老态龙钟	老態龍鍾
老态龙锺	老態龍鍾
了解	瞭解
了解到	瞭解到
了然	瞭然
了然于心	瞭然於心
了如	瞭如
了如指掌	瞭如指掌
了若指掌	瞭若指掌
李链福	李鍊福
李乾德	李乾德
李泽钜	李澤鉅
李锺郁	李鍾郁
链锤	鍊錘
链锁	鍊鎖
链条	鍊條
链形	鍊形
链坠	鍊墜
链子	鍊子
瞭望	瞭望
躏借	躪藉
凌借	凌藉
流徵	流徵
龙钟	龍鍾
龙锺	龍鍾
露复	露覆
买臣复水	買臣覆水
名复金瓯	名覆金甌
明复	明覆
明了	明瞭
麽些族	麼些族
侔德复载	侔德覆載
木吒	木吒
哪吒	哪吒
尼乾陀	尼乾陀
尼乾子	尼乾子
扭转乾坤	扭轉乾坤
彷徨	彷徨
凭借	憑藉
凭借着	憑藉着
颇复	頗覆
千锺粟	千鍾粟
钱锺书	錢鍾書
乾旦	乾旦
乾道	乾道
乾断	乾斷
乾纲	乾綱
乾卦	乾卦
乾红	乾紅
乾嘉	乾嘉
乾坤	乾坤
乾坤大挪移	乾坤大挪移
乾坤一掷	乾坤一擲
乾坤再造	乾坤再造
乾陵	乾陵
乾隆	乾隆
乾隆皇帝	乾隆皇帝
乾隆年间	乾隆年間
乾清宫	乾清宮
乾盛世	乾盛世
乾图	乾圖
乾县	乾縣
乾象	乾象
乾曜	乾曜
乾元	乾元
乾造	乾造
乾宅	乾宅
情有独钟	情有獨鍾
情有独锺	情有獨鍾
伤亡枕藉	傷亡枕藉
上链	上鍊
射复	射覆
申复	申覆
神祇	神祇
甚钜	甚鉅
示复	示覆
手链	手鍊
书中自有千锺粟	書中自有千鍾粟
素借	素藉
蒜薹	蒜薹
虽覆能复	雖覆能復
锁链	鎖鍊
铁链	鐵鍊
万锺	萬鍾
文锦复阱	文錦覆阱
无序	無序
项链	項鍊
萧乾	蕭乾
袖里乾坤	袖裏乾坤
旋乾转坤	旋乾轉坤
旋转乾坤	旋轉乾坤
旋转乾坤之力	旋轉乾坤之力
踅门了户	踅門瞭戶
雁杳鱼沉	雁杳魚沈
幺麽	么麼 么麽 幺麼
幺麽小丑	幺麼小丑 幺麼小醜
一目了然	一目瞭然
以功复过	以功覆過
以免借口	以免藉口
茵借	茵藉
银链	銀鍊
有序	有序
於敖	於敖
於崇文	於崇文
於单	於單
於乎	於乎
於呼哀哉	於呼哀哉
於梨华	於梨華
於琳	於琳
於陵子	於陵子
於伦	於倫
於穆	於穆
於其一	於其一
於潜	於潛
於清言	於清言
於世成	於世成
於坦	於坦
於菟	於菟
於惟一	於惟一
於戏	於戲
於邑	於邑
於勇明	於勇明
於则	於則
於忠祥	於忠祥
於仲完	於仲完
於竹屋	於竹屋
芸薹	蕓薹
酝借	醞藉
张法乾	張法乾
找借口	找藉口
珍珠项链	珍珠項鍊
只得	衹得
只见树木	衹見樹木
只见树木不见森林	衹見樹木不見森林
徵调	徵調
徵声	徵聲
徵弦	徵弦 徵絃
徵音	徵音
徵羽摩柯	徵羽摩柯
钟繇	鍾繇
锺锻	鍾鍛
锺馗	鍾馗
锺万梅	鍾萬梅
锺繇	鍾繇
锺重发	鍾重發
重复	重覆
肘手链足	肘手鍊足
竺乾	竺乾
钻石项链	鑽石項鍊
