鑀	鎄
鉳	錇
賓士	奔馳
冰棒	冰棍
鈽	鈈
程序不正義	程序不正義
程序正義	程序正義
鎝	鍀
砈	砹
鍅	鈁
高空彈跳	蹦極
海內存知己	海內存知己
黃宏	黃宏
機率	幾率 概率
計程車	出租車 的士
腳踏車	自行車
咖哩	咖喱
鉲	鐦
空氣清淨機	空氣淨化器
冷盤	涼菜
李彥宏	李彥宏
鎦	鑥
鋂	鎇
摩爾線程	摩爾線程
母音	元音
奈米	納米
錼	鎿
泡麵	方便麪
片語	詞組
簽帳金融卡	借記卡
乳酪	奶酪
速食麵	方便麪
塑膠	塑料
通過	通過
透過	通過
醯	酰
矽	硅
子音	輔音
字節跳動	字節跳動
