痺	痹
缽	鉢
才	纔
參	蔘
吃	喫
痴	癡
床	牀
唇	脣
潀	潨
顎	齶
峰	峯
媯	嬀
核	覈
韁	繮
稜	棱
裡	裏
么	幺
秘	祕
麵	麪
鯰	鮎
啟	啓
群	羣
抬	擡
溈	潙
偽	僞
蒍	蔿
為	爲
汙	污
嫻	嫺
洩	泄
簷	檐
睪	睾
踴	踊
灶	竈
皂	皁
針	鍼
眾	衆
著	着
粽	糉
